words	word
朝著	zhaozhu
逆境	nijing
勇于	yongyu
前进	qianjin
遇到	yudao
面对	miandui
才能	caineng
有失	youshi
看待	kandai
无法	wufa
全家	quanjia
陷入	xianru
过著	guozhu
必需	bixu
富有	fuyou
改变	gaibian
发生	fasheng
可能	keneng
音乐家	yinlejia
才子	caizi
风雨	fengyu
耳朵	erduo
音乐	yinle
命运	mingyun
不到	budao
成为	chengwei
挫折	cuozhe
成就	chengjiu
扑鼻	pubi
克服	kefu
人生	rensheng
成长	chengchang
说书人	shuoshuren
声音	shengyin
养家	yangjia
主角	zhujiao
赚钱	zhuanqian
不见	bujian
高压电	gaoyadian
残废	canfei
毅力	yili
受挫	shoucuo
活得	huode
无情	wuqing
心灵	xinling
坚持	jianchi
时候	shihou
失败	shibai
常会	changhui
蕴藏	yuncang
碰到	pengdao
关卡	guanqia
拥抱	yongbao
陷阱	xianjing
梦想	mengxiang
迎接	yingjie
双手	shuangshou
道路	daolu
经历	jingli
过程	guocheng
奋斗	fendou
次数	cishu
收获	shouhuo
发明	faming
没有	meiyou
先苦后甘	xiankuhougan
顺境	shunjing
旅程	lvcheng
追寻	zhuixun
毕生	bisheng
踏上	tashang
滋味	ziwei
禁不起	jinbuqi
感受	ganshou
神木	shenmu
被围	beiwei
锻带	duandai
西装	xizhuang
名牌	mingpai
煎熬	jianao
本钱	benqian
企业家	qiyejia
公认	gongren
透透气	toutouqi
在意	zaiyi
发觉	fajue
内心	neixin
想要	xiangyao
生气	shengqi
打开	dakai
不用	buyong
直到	zhidao
出去	chuqu
生病	shengbing
地方	difang
遭遇	zaoyu
厄运	eyun
奇迹	qiji
出现	chuxian
就算	jiusuan
不会	buhui
人祸	renhuo
磨难	monan
天灾	tianzai
强者	qiangzhe
大风	dafeng
坐在	zuozai
接受	jieshou
事情	shiqing
国父	guofu
期许	qixu
挫败	cuobai
信念	xinnian
改进	gaijin
走出	zouchu
学习	xuexi
掉入	diaoru
难过	nanguo
失望	shiwang
走过	zouguo
处在	chuzai
便是	bianshi
等待	dengdai
人们	renmen
创举	chuangju
灯泡	dengpao
照亮	zhaoliang
全世界	quanshijie
加油	jiayou
打败	dabai
办法	banfa
大家	dajia
屹立不摇	yilibuyao
小草	xiaocao
倒下	daoxia
撑过	chengguo
面临	mianlin
得到	dedao
往上爬	wangshangpa
疑问	yiwen
超世	chaoshi
有著	youzhu
意志力	yizhili
大事	dashi
小搏	xiaobo
坚忍	jianren
成果	chengguo
放弃	fangqi
相信	xiangxin
街道	jiedao
来到	laidao
看见	kanjian
世界	shijie
说明	shuoming
转捩点	zhuanliedian
老师	laoshi
人物	renwu
愿意	yuanyi
并不认为	bingburenwei
经验	jingyan
放晴	fangqing
战火	zhanhuo
被窝	beiwo
笑容	xiaorong
天空	tiankong
露出	luchu
停止	tingzhi
残叶	canye
露脸	lulian
强风	qiangfeng
磨炼	molian
污垢	wugou
鱼儿	yuer
雨水	yushui
总会	zonghui
打击	daji
初芽	chuya
豪雨	haoyu
降大任	jiangdaren
暴风	baofeng
枝干	zhigan
天将	tianjiang
古人	guren
当作	dangzuo
精神	jingshen
温室	wenshi
灭国	mieguo
逗弄	dounong
爱妾	aiqie
愚弄	yunong
摧残	cuican
大雨	dayu
花朵	huaduo
不惜	buxi
心态	xintai
属于	shuyu
人生道路	renshengdaolu
斩草	zhancao
生命力	shengmingli
希望	xiwang
中向	zhongxiang
伟人	weiren
富家	fujia
身段	shenduan
千金	qianjin
信仰	xinyang
走上	zoushang
放下	fangxia
理想	lixiang
父母	fumu
听障	tingzhang
不辍	buchuo
乐曲	lequ
性情	xingqing
留下来	liuxialai
变得	biande
作出	zuochu
堕落	duoluo
出来	chulai
新气象	xinqixiang
打得	dade
不能	buneng
开始	kaishi
图画	tuhua
景象	jingxiang
知道	zhidao
读到	dudao
传记	chuanji
改观	gaiguan
腐刑	fuxing
宫刑	gongxing
袒护	tanhu
史记	shiji
曲子	quzi
听不见	tingbujian
出名	chuming
动人	dongren
名人	mingren
自寻	zixun
短路	duanlu
小组长	xiaozuchang
念书	nianshu
理会	lihui
负责	fuze
学生	xuesheng
完成	wancheng
铸造成	zhuzaocheng
钢强	gangqiang
学者	xuezhe
被压	beiya
救护车	jiuhuche
跌倒	diedao
发现	faxian
骨头	gutou
对待	duidai
桌子	zhuozi
爸爸	baba
意识	yishi
不行	buxing
石头	shitou
冲涮	chongshuan
好比	haobi
瀑布	pubu
只能靠	zhinengkao
狂风	kuangfeng
倒塌	daota
气象	qixiang
树木	shumu
政绩	zhengji
专心	zhuanxin
开心	kaixin
思考	sikao
提起	tiqi
选择	xuanze
问题	wenti
效仿	xiaofang
样子	yangzi
应该	yinggai
再犯	zaifan
检讨	jiantao
过错	guocuo
逃避	taobi
提醒	tixing
告戒	gaojie
犯下	fanxia
灾难	zainan
错误	cuowu
防止	fangzhi
避免	bimian
靠著	kaozhu
打湿	dashi
野草	yecao
风吹	fengchui
小事	xiaoshi
圣人	shengren
悲剧	beiju
创造	chuangzao
算是	suanshi
只能	zhineng
生长	shengchang
坚强	jianqiang
习惯	xiguan
认为	renwei
带入	dairu
国小	guoxiao
小团体	xiaotuanti
女生	nvsheng
讨厌	taoyan
行列	xinglie
记得	jide
加入	jiaru
觉得	juede
拦腰	lanyao
折断	zheduan
轰炸	hongzha
树枝	shuzhi
观察	guancha
是否	shifou
蜿蜒	wanyan
停顿	tingdun
睡觉	shuijue
陪著	peizhu
不著	buzhu
恶梦	emeng
小学	xiaoxue
考卷	kaojuan
拿到	nadao
害怕	haipa
回家	huijia
记住	jizhu
朋友	pengyou
认识	renshi
事所	shisuo
起来	qilai
愈挫	yucuo
出发	chufa
但愿	danyuan
体会	tihui
再有	zaiyou
天气	tianqi
恢复	huifu
情况	qingkuang
太烂	tailan
小时候	xiaoshihou
不知	buzhi
没差	meicha
一堂课	yitangke
退缩	tuisuo
例如	liru
无限	wuxian
拥有	yongyou
赢家	yingjia
低能儿	dinenger
了不起	lebuqi
所有人	suoyouren
能够	nenggou
探起	tanqi
迎著	yingzhu
飞舞	feiwu
小鸟	xiaoniao
散步	sanbu
伸展	shenzhan
跳跃	tiaoyue
重生	zhongsheng
洗去	xiqu
灰尘	huichen
大地	dadi
动力	dongli
阶段	jieduan
水手	shuishou
造就	zaojiu
困境	kunjing
大学	daxue
迈向	maixiang
前途	qiantu
光明	guangming
挡不住	dangbuzhu
大树	dashu
万物	wanwu
时刻	shike
显得	xiande
职棒	zhibang
助益	zhuyi
球赛	qiusai
拿下	naxia
负面	fumian
机会	jihui
能力	nengli
滂沱大雨	pangtuodayu
看著	kanzhu
雨势	yushi
鸟语花香	niaoyuhuaxiang
即逝	jishi
心血	xinxie
山间	shanjian
打下	daxia
站稳脚步	zhanwenjiaobu
心胸	xinxiong
凡事	fanshi
绝望	juewang
超越	chaoyue
决心	juexin
名留青史	mingliuqingshi
激得	jide
监牢	jianlao
浪花	langhua
史学家	shixuejia
赞赏	zanshang
编写	bianxie
史书	shishu
冷血	lengxie
顺逆	shunni
大火	dahuo
实验室	shiyanshi
事物	shiwu
感情	ganqing
事实	shishi
发表	fabiao
角度	jiaodu
更让人	gengrangren
坏事	huaishi
秘密	mimi
找到	zhaodao
变回	bianhui
受到	shoudao
结束	jieshu
报导	baodao
新闻	xinwen
看到	kandao
代价	daijia
付出	fuchu
强调	qiangdiao
指纹	zhiwen
冒出	maochu
窗户	chuanghu
可爱	keai
老鼠	laoshu
变成	biancheng
同学	tongxue
犯错	fancuo
玩游戏	wanyouxi
得奖	dejiang
责骂	zema
鼓掌	guzhang
忘掉	wangdiao
功课	gongke
经典台词	jingdiantaici
学长	xuechang
坐位	zuowei
靠墙	kaoqiang
精辟	jingpi
誓言	shiyan
论点	lundian
话语	huayu
布告栏	bugaolan
下课	xiake
放学	fangxue
教室	jiaoshi
喜欢	xihuan
时间	shijian
贴著	tiezhu
奖状	jiangzhuang
文章	wenzhang
学校	xuexiao
公布	gongbu
将球	jiangqiu
彷佛	pangfo
棒球	bangqiu
扫把	saoba
用纸	yongzhi
玩玩	wanwan
男生	nansheng
打到	dadao
小心	xiaoxin
照映	zhaoying
直笛	zhidi
练到	liandao
体操比赛	ticaobisai
天使	tianshi
口号	kouhao
留在	liuzai
舞蹈	wudao
忘不了	wangbule
渡过	duguo
笑声	xiaosheng
回忆	huiyi
忘记	wangji
感觉	ganjue
蒸饭箱	zhengfanxiang
抢著	qiangzhu
好料	haoliao
弹开	dankai
飞车	feiche
变出	bianchu
白烟	baiyan
俱全	juquan
蒸气	zhengqi
蒸饭	zhengfan
饿著	ezhu
担心	danxin
垃圾桶	lajitong
黑板	heiban
角落	jiaoluo
垃圾	laji
支柱	zhizhu
景物	jingwu
摔下去	shuaixiaqu
用具	yongju
上爬	shangpa
跟随	gensui
毕业	biye
力量	liliang
空间	kongjian
学期	xueqi
一隅	yiyu
叔叔	shushu
打什球	dashenqiu
打球	daqiu
天兵	tianbing
柜子	guizi
靠近	kaojin
答案	daan
铁柜	tiegui
制铁	zhitie
装饰品	zhuangshipin
发泄	faxie
打造	dazao
家人	jiaren
工厂	gongchang
对象	duixiang
打闹	danao
嬉笑	xixiao
教诲	jiaohui
师长	shichang
熟悉	shuxi
咖啡色	kafeise
剪下	jianxia
新衣	xinyi
洋溢	yangyi
朝气	zhaoqi
向日葵	xiangrikui
残破	canpo
外表	waibiao
纸球	zhiqiu
精彩	jingcai
强打者	qiangdazhe
三振	sanzhen
全垒打	quanleida
全班	quanban
大赛	dasai
看似	kansi
涂鸦	tuya
时时	shishi
变质	bianzhi
情感	qinggan
身影	shenying
走向	zouxiang
上头	shangtou
传达	chuanda
记录	jilu
公布栏	gongbulan
自班	ziban
乱搞	luangao
名次	mingci
上课	shangke
抄著	chaozhu
联络簿	lianluobu
缺交	quejiao
不完	buwan
踏进	tajin
教科书	jiaokeshu
下课时	xiakeshi
违禁品	weijinpin
漫画书	manhuashu
人会	renhui
生教	shengjiao
训导处	xundaochu
排球	paiqiu
抓到	zhuadao
保管	baoguan
看一看	kanyikan
停下	tingxia
脚步	jiaobu
姐用	jieyong
工友	gongyou
桌椅	zhuoyi
进来	jinlai
没擦	meica
上贴	shangtie
奖牌	jiangpai
闹声	naosheng
留念	liunian
值得	zhide
知己	zhiji
椅子	yizi
了解	lejie
等著	dengzhu
书包	shubao
抛开	paokai
翻阅	fanyue
杂乱	zaluan
沉浸	chenjin
存放	cunfang
仓库	cangku
座位	zuowei
小孩子	xiaohaizi
绽放	zhanfang
学会	xuehui
心情	xinqing
消失	xiaoshi
听到	tingdao
说话	shuohua
难忘	nanwang
带给	daigei
往事	wangshi
安定	anding
想起	xiangqi
监狱	jianyu
看法	kanfa
战场	zhanchang
教课	jiaoke
打战	dazhan
急著	jizhu
还有	huanyou
讲桌	jiangzhuo
风扇	fengshan
叫醒	jiaoxing
画面	huamian
显现	xianxian
出门	chumen
上乱	shangluan
离开	likai
带来	dailai
唤起	huanqi
不可	buke
游乐场	youlechang
把玩	bawan
门窗	menchuang
身为	shenwei
欣赏	xinshang
演出	yanchu
不起	buqi
音阶	yinjie
练习	lianxi
脏乱	zangluan
打扫	dasao
重要性	zhongyaoxing
没人	meiren
继续	jixu
糟蹋	zaota
班柜	bangui
沥血	lixie
奖杯	jiangbei
才艺	caiyi
传球	chuanqiu
恶心	exin
全体	quanti
传来	chuanlai
表演	biaoyan
启示	qishi
评断	pingduan
主观	zhuguan
细节	xijie
立场	lichang
客观	keguan
处所	chusuo
舍不得	shebude
股长	guchang
扫具	saoju
小朋友	xiaopengyou
遭殃	zaoyang
迟到	chidao
逗留	douliu
早餐	zaocan
导师	daoshi
用心	yongxin
成绩	chengji
环境	huanjing
排挤	paiji
维护	weihu
课间	kejian
纸屑	zhixie
注意事项	zhuyishixiang
醒目	xingmu
散落	sanluo
八卦	bagua
课桌椅	kezhuoyi
了令	leling
感想	ganxiang
印象	yinxiang
引发	yinfa
闹区	naoqu
走道	zoudao
绿油油	lvyouyou
草坪	caoping
噪音	zaoyin
挥挥手	huihuishou
猫缆	maolan
坐著	zuozhu
乘著	chengzhu
看遍	kanbian
地球村	diqiucun
走遍	zoubian
探险家	tanxianjia
风景	fengjing
充满著	chongmanzhu
有伤	youshang
地图	ditu
需靠	xukao
面貌	mianmao
无比	wubi
众人	zhongren
维持	weichi
书柜	shugui
超乱	chaoluan
扫地	saodi
想像	xiangxiang
回收	huishou
打断	daduan
拿著	nazhu
新班	xinban
瞎猜	xiacai
粉笔	fenbi
笔记	biji
卡通人物	qiatongrenwu
整片	zhengpian
照理	zhaoli
卸妆	xiezhuang
深绿色	shenlvse
雨伞	yusan
面有	mianyou
夜景	yejing
上课时	shangkeshi
纸条	zhitiao
追逐	zhuizhu
回味	huiwei
见到	jiandao
享受	xiangshou
走到	zoudao
具处	juchu
哀号	aihao
压死	yasi
书本	shuben
拔腿就跑	batuijiupao
野兽	yeshou
力气	liqi
吸引	xiyin
好像	haoxiang
百货公司	baihuogongsi
显眼	xianyan
单调	dandiao
直立	zhili
忽视	hushi
包装	baozhuang
像是	xiangshi
改成	gaicheng
猫空	maokong
缆车	lanche
民权	minquan
下学期	xiaxueqi
缆绳	lansheng
楼顶	louding
美景	meijing
破烂	polan
车厢	chexiang
升学	shengxue
知书达理	zhishudali
足以	zuyi
知识	zhishi
压力	yali
读书声	dushusheng
欢笑	huanxiao
回荡	huidang
存在	cunzai
聊到	liaodao
谈心	tanxin
游戏	youxi
流眼泪	liuyanlei
火花	huohua
不合	buhe
谈到	tandao
意见	yijian
玩闹	wannao
学到	xuedao
放空	fangkong
洗涤	xidi
放松	fangsong
抽烟	chouyan
害人	hairen
机能	jineng
身体	shenti
造成	zaocheng
下降	xiajiang
纸类	zhilei
瓶罐	pingguan
贪图	tantu
喝完	hewan
箱子	xiangzi
饮料	yinliao
举动	judong
桌面上	zhuomianshang
刮痕	guahen
用立	yongli
可白	kebai
上写	shangxie
努力下去	nulixiaqu
团队精神	tuanduijingshen
得来	delai
来讲	laijiang
作品	zuopin
仔细观察	zixiguancha
走廊	zoulang
资源	ziyuan
抛到	paodao
作业	zuoye
用来	yonglai
全部	quanbu
午睡	wushui
罚抄	fachao
功用	gongyong
号码	haoma
名单	mingdan
水果皮	shuiguopi
司空见惯	sikongjianguan
调皮	diaopi
扮演	banyan
角色	jiaose
金钱	jinqian
抽屉	chouti
浪费	langfei
拿出	nachu
投影机	touyingji
布幕	bumu
通知单	tongzhidan
时钟	shizhong
专栏	zhuanlan
算命	suanming
好用	haoyong
布置	buzhi
找肯	zhaoken
跑腿	paotui
帮忙	bangmang
做到	zuodao
材料	cailiao
班级	banji
看看	kankan
给予	geiyu
点滴	diandi
安心	anxin
分享	fenxiang
延续	yanxu
保持	baochi
猜猜看	caicaikan
垃圾场	lajichang
好气	haoqi
好笑	haoxiao
弄坏	nonghuai
人玩	renwan
嘲笑	chaoxiao
大叫	dajiao
奇脏	qizang
碎片	suipian
手电筒	shoudiantong
电池	dianchi
玻璃	boli
喜雀	xique
配上	peishang
挥舞	huiwu
眼镜	yanjing
翅膀	chibang
望见	wangjian
夫妇	fufu
蚂蚁	mayi
碎屑	suixie
搬运	banyun
食物	shiwu
夹子	jiazi
水桶	shuitong
本班	benban
留言	liuyan
成品	chengpin
标志	biaozhi
盯著	dingzhu
画著	huazhu
线条	xiantiao
少年人	shaonianren
个性	gexing
加上	jiashang
表现	biaoxian
吵杂	chaoza
下课时间	xiakeshijian
嬉闹	xinao
讲课	jiangke
保证	baozheng
琳瑯满目	linlangmanmu
桌面	zhuomian
触动	chudong
褐色	hese
肌肤	jifu
纤维	xianwei
看不懂	kanbudong
姿势	zishi
姿态	zitai
休息	xiuxi
垃圾筒	lajitong
好帮手	haobangshou
卫生纸	weishengzhi
当成	dangcheng
处理	chuli
握手	woshou
任性	renxing
打死	dasi
可见	kejian
不肯	buken
巨作	juzuo
签下	qianxia
名画	minghua
上画	shanghua
不像	buxiang
意义	yiyi
交流	jiaoliu
呼吸	huxi
走动	zoudong
人群	renqun
烧印	shaoyin
带著	daizhu
织女	zhinv
呼呼	huhu
孕育	yunyu
思念	sinian
传到	chuandao
故事	gushi
纸团	zhituan
纠在	jiuzai
道别	daobie
天数	tianshu
后悔	houhui
距离	juli
翱翔天际	aoxiangtianji
友情	youqing
奔走	benzou
用著	yongzhu
婵娟	chanjuan
圆润	yuanrun
抚慰	fuwei
脸颊	lianjia
潮流	chaoliu
姐姐	jiejie
吹进来	chuijinlai
拉紧	lajin
外套	waitao
取暖	qunuan
起床	qichuang
被子	beizi
感冒	ganmao
止不住	zhibuzhu
带团	daituan
倒楣	daomei
游览车	youlanche
导游	daoyou
想念	xiangnian
受伤	shoushang
丧失	sangshi
可怜	kelian
砥砺	dili
原地	yuandi
季里	jili
诉说	sushuo
歌舞	gewu
心目	xinmu
引起	yinqi
物品	wupin
随著	suizhu
木头	mutou
刮伤	guashang
用铁	yongtie
桌脚	zhuojiao
小时	xiaoshi
上少	shangshao
工具	gongju
香菇	xianggu
图片	tupian
暮阳	muyang
鸟鸣	niaoming
婉转	wanzhuan
枝叶	zhiye
修理	xiuli
音浪	yinlang
偷听	touting
排开	paikai
浮力	fuli
抒发	shufa
所受	suoshou
体积	tiji
等于	dengyu
爱惜	aixi
公物	gongwu
很漂亮	henpiaoliang
注意	zhuyi
擦掉	cadiao
抹布	mobu
看上去	kanshangqu
满意	manyi
结果	jieguo
菜市场	caishichang
专属	zhuanshu
位子	weizi
响起	xiangqi
原本	yuanben
磺在	huangzai
小游戏	xiaoyouxi
画格	huage
圈叉	quancha
复制	fuzhi
光阴	guangyin
看不到	kanbudao
换新	huanxin
潮水	chaoshui
涌出	yongchu
记忆	jiyi
时儿	shier
走著	zouzhu
窗台	chuangtai
树梢	shushao
电灯	diandeng
猎人	lieren
麻雀	maque
闪电	shandian
磨菇	mogu
虚幻	xuhuan
犹如	youru
幻想	huanxiang
愤怒	fennu
放著	fangzhu
亮眼	liangyan
抬头	taitou
班会	banhui
学艺股长	xueyiguchang
撕得	side
学术	xueshu
忙著	mangzhu
评分	pingfen
想来	xianglai
打算	dasuan
参加	canjia
出自	chuzi
得名	deming
期待	qidai
妈妈	mama
关心	guanxin
四射	sishe
至极	zhiji
臭味	chouwei
观念	guannian
分类	fenlei
中饭	zhongfan
睡午觉	shuiwujue
画图	huatu
莫名	moming
依赖	yilai
位置	weizhi
照不到	zhaobudao
老高	laogao
灯光	dengguang
地带	didai
黑色	heise
铁栏杆	tielangan
望著	wangzhu
坐落于	zuoluoyu
发呆	fadai
争吵	zhengchao
哭泣	kuqi
培养	peiyang
人生旅途	renshenglvtu
瞭如	liaoru
指掌	zhizhang
进出	jinchu
上学	shangxue
可惜	kexi
盼望	panwang
期望	qiwang
扶持	fuchi
回来	huilai
老师上课	laoshishangke
插画	chahua
要用	yaoyong
好事	haoshi
手绘	shouhui
国旗	guoqi
人贴	rentie
创意	chuangyi
走进	zoujin
开著	kaizhu
寒流	hanliu
笼子	longzi
未交	weijiao
粒屎	lishi
恶作剧	ezuoju
绰号	chuohao
包容	baorong
归属感	guishugan
飞去	feiqu
接纳	jiena
缺点	quedian
乱画	luanhua
锯下来	juxialai
爱护	aihu
破坏	pohuai
是从	shicong
所待	suodai
同侪	tongchai
地盘	dipan
照顾	zhaogu
污点	wudian
留下	liuxia
照进来	zhaojinlai
缝隙	fengxi
读书	dushu
公园	gongyuan
握著	wozhu
撒落	saluo
木椅	muyi
老奶奶	laonainai
映出	yingchu
玩耍	wanshua
金色	jinse
关不紧	guanbujin
懒得	lande
不堪	bukan
寿命	shouming
开门	kaimen
降低	jiangdi
导致	daozhi
抄下	chaoxia
闲暇	xianxia
洗不掉	xibudiao
吊著	diaozhu
桌角	zhuojiao
坑洞	kengdong
椅背	yibei
天花板	tianhuaban
总能	zongneng
看起来	kanqilai
场所	changsuo
吸收	xishou
缺少美	queshaomei
含义	hanyi
缺少	queshao
房间	fangjian
搬家	banjia
不了	bule
伴侣	banlv
风采	fengcai
喜爱	xiai
种下	zhongxia
弟妹	dimei
包括	baokuo
听课	tingke
教学	jiaoxue
上开	shangkai
铝箔	lvbo
果蝇	guoying
派对	paidui
瓶子	pingzi
实在	shizai
放置	fangzhi
怀念	huainian
需要	xuyao
看景	kanjing
倒映	daoying
俯视	fushi
歇息	xiexi
无趣	wuqu
心神	xinshen
凝聚	ningju
专注	zhuanzhu
专用	zhuanyong
瞳铃	tongling
下课铃	xiakeling
流窜	liucuan
魔力	moli
耳畔	erpan
唤醒	huanxing
活力	huoli
血液	xieye
注入	zhuru
玩乐	wanle
乐器	leqi
垃圾袋	lajidai
垃圾车	lajiche
音调	yindiao
绑架	bangjia
时会	shihui
异形	yixing
起降	qijiang
飞机	feiji
称为	chengwei
秘籍	miji
抢眼	qiangyan
声响	shengxiang
上所	shangsuo
所得	suode
事项	shixiang
相关	xiangguan
篮板	lanban
篮球	lanqiu
可知	kezhi
控球	kongqiu
生疏	shengshu
陪伴	peiban
归来	guilai
趴下	paxia
回想	huixiang
岗位	gangwei
外地	waidi
坚守	jianshou
日子	rizi
踩破	caipo
震到	zhendao
尖叫声	jianjiaosheng
吓死	xiasi
吵闹	chaonao
听力	tingli
受损	shousun
忍著	renzhu
小动作	xiaodongzuo
弄成	nongcheng
水滴	shuidi
图案	tuan
学姐	xuejie
剪贴	jiantie
爱看	aikan
炒饭	chaofan
舞台剧	wutaiju
米饭	mifan
句子	juzi
深思	shensi
有没有	youmeiyou
权利	quanli
所有物	suoyouwu
善待	shandai
校园	xiaoyuan
国家	guojia
笑著	xiaozhu
装满	zhuangman
茶杯	chabei
喝茶	hecha
想法	xiangfa
读著	duzhu
好书	haoshu
品质	pinzhi
证明	zhengming
嬉戏	xixi
交到	jiaodao
交谈	jiaotan
对话	duihua
体认	tiren
离合	lihe
填满	tianman
人情	renqing
处处	chuchu
说不出	shuobuchu
接触	jiechu
考试卷	kaoshijuan
对著	duizhu
摆著	baizhu
傻笑	shaxiao
想想	xiangxiang
存留	cunliu
装饰	zhuangshi
寻找	xunzhao
回到	huidao
遗忘	yiwang
看得见	kandejian
埋没	maimei
用处	yongchu
应有	yingyou
小天地	xiaotiandi
小窝	xiaowo
弄乱	nongluan
坐到	zuodao
我会	wohui
回头	huitou
表面	biaomian
主人	zhuren
再见	zaijian
意思	yisi
失物	shiwu
待领	dailing
外堂	waitang
交回	jiaohui
作业本	zuoyeben
贵重物品	guizhongwupin
开锁	kaisuo
挂著	guazhu
所该	suogai
回溯	huisu
叮咛	dingning
时光	shiguang
把握	bawo
云朵	yunduo
鸟儿	niaoer
汗水	hanshui
开花	kaihua
落下	luoxia
极限运动	jixianyundong
公车站	gongchezhan
滑板	huaban
游民	youmin
脚踏车	jiaotache
舞者	wuzhe
穿梭	chuansuo
玩家	wanjia
放书	fangshu
安慰	anwei
原因	yuanyin
获得	huode
数位	shuwei
授课	shouke
浮现	fuxian
回顾	huigu
影片	yingpian
保留	baoliu
一格	yige
变强	bianqiang
棋子	qizi
棋盘	qipan
地板	diban
对手	duishou
没扫	meisao
脚印	jiaoyin
打扮	daban
决定	jueding
区域	quyu
玩完	wanwan
战争	zhanzheng
型态	xingtai
伤心	shangxin
玩具	wanju
情愿	qingyuan
拿来	nalai
时身	shishen
秩序	zhixu
怨言	yuanyan
厌恶	yane
责任	zeren
使用	shiyong
作画	zuohua
回馈	huikui
计较	jijiao
贡献	gongxian
有所	yousuo
伙伴	huoban
书库	shuku
感人	ganren
上学时	shangxueshi
回答	huida
国字	guozi
音符	yinfu
图腾	tuteng
搭配	dapei
颜色	yanse
数字	shuzi
衣服	yifu
报到	baodao
没错	meicuo
凹陷	aoxian
脑子里	naozili
徘徊	paihuai
修复	xiufu
教会	jiaohui
摆设	baishe
白板	baiban
特色	tese
物体	wuti
任何事物	renheshiwu
身子	shenzi
告诉	gaosu
空格	kongge
怒骂	numa
品行	pinxing
摆放	baifang
领悟	lingwu
领略	linglve
尊敬	zunjing
低下	dixia
后果	houguo
欺负	qifu
忍受	renshou
奇怪	qiguai
俱备	jubei
灯塔	dengta
交响曲	jiaoxiangqu
身躯	shenqu
重回	zhonghui
灭迹	mieji
课业	keye
重漆	zhongqi
同班	tongban
烙印	luoyin
打拼	dapin
大水	dashui
抱怨	baoyuan
想到	xiangdao
放在	fangzai
搞不好	gaobuhao
连续剧	lianxuju
讲台	jiangtai
有用	youyong
目光	muguang
做好	zuohao
不想	buxiang
钟响	zhongxiang
玩分	wanfen
双方	shuangfang
派系	paixi
爱玩	aiwan
乱写	luanxie
堆满	duiman
角落里	jiaoluoli
后头	houtou
痕迹	henji
流到	liudao
开学	kaixue
口水	koushui
结为	jiewei
趴在	pazai
陌生	mosheng
追打	zhuida
爆满	baoman
后门	houmen
割到	gedao
重贴	zhongtie
扯到	chedao
海报	haibao
篇文章	pianwenzhang
差太	chatai
比起	biqi
冲出去	chongchuqu
捡起	jianqi
践踏	jianta
装作	zhuangzuo
明知	mingzhi
兴奋	xingfen
探索	tansuo
余地	yudi
刷刷牙	shuashuaya
口香糖	kouxiangtang
鼻涕	biti
嘴巴	zuiba
每枝	meizhi
异国	yiguo
画笔	huabi
做为	zuowei
风情	fengqing
历程	licheng
画家	huajia
得出	dechu
幼稚园	youzhiyuan
补习班	buxiban
求学	qiuxue
中学	zhongxue
下棋	xiaqi
打架	dajia
过动	guodong
血气方刚	xieqifanggang
免不了	mianbule
秀才	xiucai
夸奖	kuajiang
发言	fayan
优点	youdian
采用	caiyong
早自习	zaozixi
温存	wencun
铺盖	pugai
扫除	saochu
看书	kanshu
等候	denghou
穿著	chuanzhu
公用	gongyong
脑海	naohai
生科	shengke
咒骂	zhouma
便成	biancheng
拥护者	yonghuzhe
勾起	gouqi
开口	kaikou
跑跳	paotiao
保密	baomi
心事	xinshi
教书	jiaoshu
整间	zhengjian
排得	paide
进去	jinqu
出气筒	chuqitong
考试成绩	kaoshichengji
抄写	chaoxie
辱骂	ruma
度过	duguo
伴随	bansui
有点	youdian
私底下	sidixia
人情味	renqingwei
帮助	bangzhu
教授	jiaoshou
插曲	chaqu
玩笑	wanxiao
时分	shifen
动作	dongzuo
书桌	shuzhuo
巨子	juzi
赔钱	peiqian
公分	gongfen
小猪	xiaozhu
幻灯片	huandengpian
轶事	yishi
年少	nianshao
品味	pinwei
寄托	jituo
叫累	jiaolei
极品	jipin
器材	qicai
留给	liugei
听著	tingzhu
解放	jiefang
代表	daibiao
上停	shangting
好客	haoke
人缘	renyuan
特质	tezhi
花瓣	huaban
昆虫	kunchong
象征	xiangzheng
板擦	banca
赏画	shanghua
扫帚	saozhou
风流	fengliu
顾虑	gulv
艺术家	yishujia
防范	fangfan
异味	yiwei
用到	yongdao
叫做	jiaozuo
找寻	zhaoxun
电风扇	dianfengshan
喧闹	xuannao
底纸	dizhi
贴满	tieman
边框	biankuang
深蓝色	shenlanse
纸张	zhizhang
排成	paicheng
拼下	pinxia
厨余桶	chuyutong
蛤蜊	hali
催缴	cuijiao
花点	huadian
鱼骨	yugu
战绩	zhanji
走近	zoujin
须要	xuyao
写字	xiezi
生涯	shengya
赶进	ganjin
全校	quanxiao
电视	dianshi
公告栏	gonggaolan
接力	jieli
大队	dadui
停留	tingliu
幼苗	youmiao
传授	chuanshou
产生	chansheng
感动	gandong
牺牲	xisheng
就让	jiurang
班用	banyong
班费	banfei
放到	fangdao
做错	zuocuo
野猪	yezhu
小孩	xiaohai
草原	caoyuan
特征	tezheng
班导	bandao
划破	huapo
天际	tianji
发疯	fafeng
人手	renshou
兵团	bingtuan
影子	yingzi
主义者	zhuyizhe
废物	feiwu
进取	jinqu
手脚	shoujiao
整理	zhengli
暗藏	ancang
苦心人	kuxinren
评比	pingbi
皇天	huangtian
不负	bufu
不够	bugou
困扰	kunrao
打量	daliang
后乐	houle
先乐	xianle
到达	daoda
方向	fangxiang
数理逻辑	shuliluoji
方面	fangmian
依靠	yikao
程度	chengdu
选定	xuanding
迷失	mishi
称职	chengzhi
目标	mubiao
改掉	gaidiao
领悟到	lingwudao
所犯	suofan
鼓励	guli
道理	daoli
知觉	zhijue
思想	sixiang
旋律	xuanlv
不悔	buhui
邮轮	youlun
赚大钱	zhuandaqian
帆船	fanchuan
饭店	fandian
爸妈	bama
负担	fudan
设立	sheli
迈进	maijin
人则	renze
懂得	dongde
想当	xiangdang
名车	mingche
代理商	dailishang
年轻人	nianqingren
兴趣	xingqu
相似	xiangsi
走音	zouyin
管弦乐团	guanxianletuan
乐团	letuan
知名	zhiming
新闻报导	xinwenbaodao
形形色色	xingxingsese
停下来	tingxialai
不妨	bufang
璞玉	puyu
树叶	shuye
雕刻	diaoke
上能	shangneng
顺遂	shunsui
学业	xueye
找出	zhaochu
战胜	zhansheng
行船	xingchuan
宽度	kuandu
拓展	tuozhan
双脚	shuangjiao
行走	xingzou
毫无	haowu
障碍	zhangai
体验	tiyan
正义	zhengyi
退步	tuibu
心房	xinfang
招来	zhaolai
往前走	wangqianzou
境界	jingjie
现状	xianzhuang
羡慕	xianmu
心想	xinxiang
用功读书	yonggongdushu
图书馆	tushuguan
起跑点	qipaodian
跑者	paozhe
巅峰	dianfeng
拟定	niding
抵达	dida
加速	jiasu
课余	keyu
好手	haoshou
因素	yinsu
运动员	yundongyuan
抓住	zhuazhu
选完	xuanwan
未及	weiji
变换	bianhuan
愿望	yuanwang
控制	kongzhi
拒绝	jujue
解决	jiejue
方法	fangfa
单指	danzhi
挥霍	huihuo
局限于	juxianyu
要来	yaolai
定义	dingyi
适合	shihe
踪向	zongxiang
专长	zhuanchang
握有	woyou
横向	hengxiang
奠定	dianding
港口	gangkou
考差	kaocha
如愿	ruyuan
考上	kaoshang
志愿	zhiyuan
苦读	kudu
榜样	bangyang
设定	sheding
指引	zhiyin
开车	kaiche
职篮	zhilan
常人	changren
不放	bufang
出色	chuse
遭受	zaoshou
先生	xiansheng
进入	jinru
电玩	dianwan
存够	cungou
买下	maixia
不太好	butaihao
引导	yindao
能朝	nengzhao
空闲	kongxian
方条	fangtiao
头绪	touxu
突发状况	tufazhuangkuang
人能	renneng
过于	guoyu
奠下	dianxia
基测	jice
放荡	fangdang
还来	huanlai
贯通	guantong
有钱	youqian
选坏	xuanhuai
戒掉	jiediao
上瘾	shangyin
引诱	yinyou
自杀	zisha
聪明人	congmingren
改行	gaixing
立志	lizhi
路途	lutu
追求	zhuiqiu
加以	jiayi
善念	shannian
度日	duri
过日子	guorizi
感到	gandao
差点	chadian
掌握	zhangwo
数学公式	shuxuegongshi
勉励	mianli
教导	jiaodao
数学家	shuxuejia
殆尽	daijin
外人	wairen
保护	baohu
就读	jiudu
毒品	dupin
杀人	sharen
来不及	laibuji
迷宫	migong
听说	tingshuo
歪路	wailu
歪斜	waixie
看向	kanxiang
贫穷人家	pinqiongrenjia
习惯于	xiguanyu
套房	taofang
出生	chusheng
正路	zhenglu
展现	zhanxian
时机	shiji
累积	leiji
爬升	pasheng
喜好	xihao
学问	xuewen
翻身	fanshen
实践	shijian
建议	jianyi
前科	qianke
释放出来	shifangchulai
送进	songjin
阴影	yinying
善用	shanyong
想有	xiangyou
上择	shangze
选则	xuanze
看电视	kandianshi
准备	zhunbei
律师	lvshi
反复	fanfu
类似	leisi
动摇	dongyao
帮派	bangpai
份子	fenzi
吸毒	xidu
心力	xinli
增进	zengjin
争取	zhengqu
科学家	kexuejia
动物	dongwu
植物	zhiwu
科学	kexue
阳台	yangtai
宇宙	yuzhou
全都	quandu
琢磨	zhuomo
等到	dengdao
圈路	quanlu
死路	silu
原点	yuandian
捷径	jiejing
改正	gaizheng
只取	zhiqu
无悔	wuhui
承受	chengshou
步伐	bufa
游乐器	youleqi
心酸	xinsuan
年龄	nianling
好坏	haohuai
大人	daren
在于	zaiyu
做错事	zuocuoshi
学坏	xuehuai
体悟	tiwu
咖啡厅	kafeiting
志向	zhixiang
有钱人	youqianren
选对	xuandui
厌烦	yanfan
遵从	zuncong
态度	taidu
规画	guihua
了要	leyao
画画	huahua
不计	buji
感兴趣	ganxingqu
人间	renjian
基础	jichu
建立	jianli
所指	suozhi
善侍	shanshi
交朋友	jiaopengyou
学历	xueli
牵著	qianzhu
权力	quanli
想著	xiangzhu
打篮球	dalanqiu
赞成	zancheng
进德修业	jindexiuye
养成	yangcheng
现实	xianshi
猜忌	caiji
日出	richu
无需	wuxu
笼罩	longzhao
直呼	zhihu
一流	yiliu
留学	liuxue
考不完	kaobuwan
成败	chengbai
自信	zixin
悔改	huigai
书念	shunian
歧路	qilu
指南针	zhinanzhen
决定性	juedingxing
先画	xianhua
草稿	caogao
全盘	quanpan
朝向	zhaoxiang
疏忽	shuhu
工程	gongcheng
挖掘出	wajuechu
轻言	qingyan
敞开	changkai
未知	weizhi
用想	yongxiang
钻研	zuanyan
光是	guangshi
唱歌	changge
达成	dacheng
突出	tuchu
父亲	fuqin
了头	letou
冲昏	chonghun
用功	yonggong
谈恋爱	tanlianai
报酬率	baochoulv
不多	buduo
荡到	dangdao
罹患	lihuan
贴心	tiexin
细心	xixin
扇门	shanmen
效法	xiaofa
钥匙	yaochi
女士	nvshi
自制	zizhi
欲望	yuwang
叉路	chalu
标示牌	biaoshipai
恶魔	emo
击破	jipo
阻挠	zunao
对抗	duikang
人生目标	renshengmubiao
跆拳道	taiquandao
国手	guoshou
登上	dengshang
舞台	wutai
邀请	yaoqing
名声	mingsheng
博士	boshi
考察	kaocha
电力	dianli
提升	tisheng
电机	dianji
要会	yaohui
修好	xiuhao
电脑	diannao
数学	shuxue
机础	jichu
决择	jueze
懵懂	mengdong
畏惧	weiju
无知	wuzhi
寻求	xunqiu
憧憬	chongjing
启发	qifa
疑惑	yihuo
信心	xinxin
先存	xiancun
乱花钱	luanhuaqian
想买	xiangmai
克制	kezhi
出手	chushou
积积	jiji
善事	shanshi
弥补	mibu
群聚	qunju
直冲	zhichong
融入	rongru
气质	qizhi
天生	tiansheng
脾气	piqi
领导者	lingdaozhe
风范	fengfan
气度	qidu
处事	chushi
做人	zuoren
资格	zige
焦点	jiaodian
人才	rencai
童心	tongxin
心志	xinzhi
真实性	zhenshixing
可笑	kexiao
思索	sisuo
缺乏	quefa
做出	zuochu
做对	zuodui
引路	yinlu
好心	haoxin
变硬	bianying
餐食	canshi
订好	dinghao
音乐系	yinlexi
学太	xuetai
父母亲	fumuqin
亲人	qinren
例外	liwai
分为	fenwei
车子	chezi
上错	shangcuo
计画	jihua
开到	kaidao
修车	xiuche
小汽车	xiaoqiche
老板	laoban
员工	yuangong
倒数	daoshu
拼命	pinming
理化	lihua
规律	guilv
人定胜天	rendingshengtian
饮恨	yinhen
败北	baibei
苦心	kuxin
占卜	zhanbu
拍手	paishou
锻练	duanlian
武术	wushu
风向	fengxiang
指向	zhixiang
心理	xinli
生物	shengwu
承担	chengdan
要选	yaoxuan
亏心事	kuixinshi
选好	xuanhao
说谎	shuohuang
乐谱	lepu
演奏家	yanzoujia
赞叹	zantan
钢琴	gangqin
减少	jianshao
起手	qishou
解决问题	jiejuewenti
难题	nanti
实现	shixian
耳边风	erbianfeng
吸烟	xiyan
不顾	bugu
避冬	bidong
飞散	feisan
饿死	esi
欺骗	qipian
沉沦	chenlun
考虑	kaolv
水流	shuiliu
抱著	baozhu
摘取	zhaiqu
旗子	qizi
尝到	changdao
标杆	biaogan
折磨	zhemo
行为	xingwei
偏差	piancha
来得及	laideji
好吃	haochi
撑住	chengzhu
决定权	juedingquan
瓶颈	pingjing
流行	liuxing
团体	tuanti
方式	fangshi
回不来	huibulai
漫长	manchang
错失	cuoshi
把握住	bawozhu
改向	gaixiang
倒退	daotui
开阔	kaikuo
主见	zhujian
跟著	genzhu
不让	burang
遗失	yishi
重来	zhonglai
白费	baifei
连想	lianxiang
没想	meixiang
天分	tianfen
选错	xuancuo
交给	jiaogei
时期	shiqi
平民	pingmin
找回	zhaohui
必备	bibei
失去	shiqu
条件	tiaojian
牢记在心	laojizaixin
反省	fansheng
路程	lucheng
批评	piping
效果	xiaoguo
加强	jiaqiang
人人	renren
燃起	ranqi
心意	xinyi
抓周	zhuazhou
要当	yaodang
铅笔	qianbi
职业	zhiye
蕴含	yunhan
方位	fangwei
向来	xianglai
财富	caifu
面对现实	mianduixianshi
大洞	dadong
陪我玩	peiwowan
色彩	secai
校歌	xiaoge
所写	suoxie
后退	houtui
拖延	tuoyan
人家	renjia
拖著	tuozhu
心理准备	xinlizhunbei
厨师	chushi
发掘	fajue
譬如	piru
平地	pingdi
做事	zuoshi
警惕	jingti
邮差	youcha
想去	xiangqu
社会	shehui
中央	zhongyang
抓好	zhuahao
下手	xiashou
运气	yunqi
当会	danghui
没用	meiyong
书堆	shudui
缺憾	quehan
造福	zaofu
闭门	bimen
弟子	dizi
殿堂	diantang
眼光	yanguang
想选	xiangxuan
不算	busuan
头脑	tounao
外界	waijie
判断	panduan
人类	renlei
酒肉朋友	jiuroupengyou
造不出	zaobuchu
想走	xiangzou
不平	buping
照料	zhaoliao
相反	xiangfan
小弯	xiaowan
全部都是	quanbudushi
弯道	wandao
走时	zoushi
漫无	manwu
小树	xiaoshu
小花	xiaohua
主宰	zhuzai
关在	guanzai
不该	bugai
路标	lubiao
牵引	qianyin
摸索	mosuo
著书	zhushu
定下	dingxia
游荡	youdang
走对	zoudui
好感	haogan
流落	liuluo
头痛	toutong
走错	zoucuo
补救	bujiu
缺口	quekou
音感	yingan
歌喉	gehou
天赐	tianci
礼物	liwu
行于	xingyu
试著	shizhu
丧气	sangqi
笨蛋	bendan
心会	xinhui
指指点点	zhizhidiandian
羞辱	xiuru
轮子	lunzi
出世	chushi
关系	guanxi
坏人	huairen
好人	haoren
彩色	caise
招牌	zhaopai
心来	xinlai
是善	shishan
带往	daiwang
岔路	chalu
性格	xingge
为学	weixue
理智	lizhi
要订	yaoding
放胆	fangdan
下结论	xiajielun
男女朋友	nannvpengyou
变差	biancha
生活习惯	shenghuoxiguan
念头	niantou
吃饭	chifan
抉择	jueze
航行	hangxing
演变	yanbian
好运	haoyun
更该	genggai
听完	tingwan
实例	shili
大学毕业	daxuebiye
还好	huanhao
分明	fenming
个人	geren
少子	shaozi
文凭	wenping
趋势	qushi
实行	shixing
全能	quanneng
小声	xiaosheng
话别	huabie
琐事	suoshi
可要	keyao
请问	qingwen
有为	youwei
体质	tizhi
感谢	ganxie
同情	tongqing
医生	yisheng
医院	yiyuan
著如	zhuru
闪耀	shanyao
光彩	guangcai
光芒	guangmang
方向盘	fangxiangpan
虚度	xudu
开往	kaiwang
最高点	zuigaodian
死看	sikan
病者	bingzhe
夺走	duozou
心爱	xinai
低收入	dishouru
读完	duwan
坚信	jianxin
目的	mude
达到	dadao
让你在	rangnizai
认同	rentong
免得	miande
违反	weifan
砖头	zhuantou
掉下去	diaoxiaqu
带我去	daiwoqu
哭诉	kusu
开窍	kaiqiao
建中	jianzhong
掉下来	diaoxialai
潜能	qianneng
亏待	kuidai
力争上游	lizhengshangyou
全家人	quanjiaren
吵架	chaojia
家庭	jiating
得不到	debudao
转错	zhuancuo
思考问题	sikaowenti
带到	daidao
走路	zoulu
行行出状元	xingxingchuzhuangyuan
订出	dingchu
异事	yishi
奇人	qiren
提出	tichu
大雄	daxiong
道具	daoju
过人	guoren
勇气	yongqi
上帝	shangdi
我心	woxin
足够	zugou
发光	faguang
发热	fare
被人	beiren
唾弃	tuoqi
大人物	darenwu
取自	quzi
升高	shenggao
棒球队	bangqiudui
迷上	mishang
见闻	jianwen
缘故	yuangu
位于	weiyu
性向测验	xingxiangceyan
顺著	shunzhu
可正	kezheng
记忆力	jiyili
书籍	shuji
前任	qianren
盛产	shengchan
好转	haozhuan
买卖	maimai
比做	bizuo
好听	haoting
变数	bianshu
单程票	danchengpiao
补习	buxi
行百里	xingbaili
要素	yaosu
填选	tianxuan
填填	tiantian
引响	yinxiang
射向	shexiang
降落	jiangluo
在行	zaixing
互想	huxiang
订下	dingxia
告诫	gaojie
对方	duifang
弃权	qiquan
偷懒	toulan
挡住	dangzhu
芝麻小事	zhimaxiaoshi
否定	fouding
生存	shengcun
残障	canzhang
长颈鹿	changjinglu
冒险	maoxian
探讨	tantao
编排	bianpai
飘浮	piaofu
溜走	liuzou
致于	zhiyu
歧途	qitu
外界影响	waijieyingxiang
明灯	mingdeng
不致于	buzhiyu
透过	touguo
看过	kanguo
以加	yijia
研读	yandu
涉猎	shelie
胡诌	huzou
碎石	suishi
满地	mandi
定论	dinglun
良药	liangyao
落到	luodao
大钱	daqian
偶像	ouxiang
精英	jingying
挽回	wanhui
称赞	chengzan
形成	xingcheng
分母	fenmu
括号	kuohao
记取	jiqu
马路	malu
跨出	kuachu
收拾	shoushi
走完	zouwan
输赢	shuying
资质	zizhi
关键	guanjian
赢来	yinglai
确定	queding
掌舵	zhangduo
耸立	songli
渴望	kewang
高度	gaodu
绊脚石	banjiaoshi
意念	yinian
错过	cuoguo
干扰	ganrao
成图	chengtu
字画	zihua
懒散	lansan
锻炼	duanlian
所做	suozuo
应往	yingwang
著想	zhuxiang
热心	rexin
施加	shijia
得能	deneng
传爱	chuanai
重围	zhongwei
人为	renwei
语文能力	yuwennengli
口才	koucai
铺路	pulu
上完	shangwan
悔恨	huihen
操心	caoxin
够不够	goubugou
热衷	rezhong
要求	yaoqiu
满烂	manlan
科目	kemu
必胜	bisheng
懊悔不已	aohuibuyi
阐扬	chanyang
民主自由	minzhuziyou
鼓吹	guchui
提倡	tichang
语文	yuwen
写作	xiezuo
卖命	maiming
擅长	shanchang
作为	zuowei
错路	cuolu
选到	xuandao
偷钱	touqian
死神	sishen
犯罪者	fanzuizhe
处罚	chufa
警方	jingfang
处置	chuzhi
选出	xuanchu
筹码	chouma
无妨	wufang
惨状	canzhuang
踏入	taru
挥手	huishou
本份	benfen
可有	keyou
标竿	biaogan
金句	jinju
得胜	desheng
送给	songgei
医师	yishi
字眼	ziyan
知错	zhicuo
寄望	jiwang
大儿子	daerzi
纠正	jiuzheng
订太	dingtai
玩岁愒日	wansuikairi
体育老师	tiyulaoshi
不输给	bushugei
买不起	maibuqi
行业	xingye
乞丐	qigai
投入	touru
心愿	xinyuan
状况	zhuangkuang
协助	xiezhu
更累	genglei
骑会	qihui
踩著	caizhu
踏板	taban
抗压性	kangyaxing
带离	daili
政治界	zhengzhijie
恒心	hengxin
闪躲	shanduo
出国	chuguo
眼神	yanshen
复习	fuxi
怀著	huaizhu
孩童	haitong
意志	yizhi
大众	dazhong
出让	churang
嗜好	shihao
改造	gaizao
民宅	minzhai
起眼	qiyan
设计师	shejishi
豪宅	haozhai
节目	jiemu
棒球场	bangqiuchang
住家	zhujia
飞来	feilai
球队	qiudui
报名	baoming
退出	tuichu
飘移	piaoyi
吹拂	chuifu
任由	renyou
玩弄	wannong
羽毛	yumao
导航	daohang
带领	dailing
光束	guangshu
神医	shenyi
糕点	gaodian
治疗	zhiliao
车尾	chewei
看好	kanhao
接近	jiejin
拿手	nashou
请教	qingjiao
设在	shezai
带你去	dainiqu
行医	xingyi
可逆	keni
凡人	fanren
性命	xingming
跌入	dieru
诱惑	youhuo
树林	shulin
山谷	shangu
全身	quanshen
划到	huadao
胜者	shengzhe
对岸	duian
开创	kaichuang
需不需要	xubuxuyao
择取	zequ
盲目	mangmu
更换	genghuan
丧志	sangzhi
凭著	pingzhu
筑出	zhuchu
终究会	zhongjiuhui
灰心	huixin
操控	caokong
结局	jieju
右转	youzhuan
球员	qiuyuan
目的地	mudedi
打出	dachu
变好	bianhao
会成	huicheng
检察官	jianchaguan
帐户	zhanghu
案子	anzi
人头	rentou
价钱	jiaqian
图形	tuxing
工程师	gongchengshi
讨论	taolun
总统	zongtong
精读	jingdu
财产	caichan
损失	sunshi
星光	xingguang
大道	dadao
艺术	yishu
天赋	tianfu
摇摆	yaobai
刀剑	daojian
妄想	wangxiang
泪珠	leizhu
插入	charu
句点	judian
行何业	xingheye
得成	decheng
专科	zhuanke
田径队	tianjingdui
裁缝	caifeng
欣慰	xinwei
艺人	yiren
身材	shencai
信任	xinren
不得	bude
走失	zoushi
迷路	milu
犯人	fanren
看清	kanqing
没法	meifa
地基	diji
时代	shidai
羔羊	gaoyang
政治腐败	zhengzhifubai
人民	renmin
官员	guanyuan
政治	zhengzhi
听信	tingxin
留美	liumei
机率	jilv
从事	congshi
水果店	shuiguodian
电脑游戏	diannaoyouxi
送货	songhuo
多姿	duozi
美食	meishi
妹妹	meimei
要读	yaodu
夜校	yexiao
上菜	shangcai
家政	jiazheng
吃掉	chidiao
美食家	meishijia
紧记	jinji
取笑	quxiao
味道	weidao
活著	huozhu
慰藉	weijie
奔驰	benchi
接著	jiezhu
认清	renqing
理科	like
差异	chayi
条路	tiaolu
不回	buhui
专精	zhuanjing
开发	kaifa
人材	rencai
做起	zuoqi
反悔	fanhui
脑子	naozi
品性	pinxing
歌手	geshou
死亡	siwang
想开	xiangkai
误入	wuru
题目	timu
善者	shanzhe
课本	keben
不善	bushan
骂人	maren
水准	shuizhun
补强	buqiang
目地	mudi
行驶	xingshi
心则	xinze
机长	jichang
护士	hushi
警察	jingcha
看病	kanbing
爱财	aicai
了去	lequ
看诊	kanzhen
贪财	tancai
名望	mingwang
反感	fangan
没了	meile
随风飘	suifengpiao
风是	fengshi
定立	dingli
技艺	jiyi
赢得	yingde
雕好	diaohao
坏习惯	huaixiguan
琴谱	qinpu
诠释	quanshi
挑选	tiaoxuan
低落	diluo
情绪	qingxu
潜伏	qianfu
考好	kaohao
赶出来	ganchulai
占据	zhanju
减轻负担	jianqingfudan
洗碗	xiwan
凉意	liangyi
表象	biaoxiang
友人	youren
晚餐	wancan
限于	xianyu
密集	miji
世纪	shiji
镇定剂	zhendingji
解脱	jietuo
烈火	liehuo
认知	renzhi
桌球	zhuoqiu
球桌	qiuzhuo
度假	dujia
入心	ruxin
发自	fazi
假象	jiaxiang
考场	kaochang
倒不如	daoburu
活人	huoren
抽象	chouxiang
看看书	kankanshu
背负	beifu
球场上	qiuchangshang
好友	haoyou
爱心	aixin
事能	shineng
考式	kaoshi
份量	fenliang
在乎	zaihu
分数	fenshu
涌出来	yongchulai
挖掘	wajue
互相学习	huxiangxuexi
切磋	qiecuo
老友	laoyou
宣泄	xuanxie
每逢	meifeng
事事	shishi
赶走	ganzou
吐出来	tuchulai
大笑	daxiao
不住	buzhu
合奏	hezou
独奏	duzou
微物	weiwu
细察	xicha
纹理	wenli
失聪	shicong
奇才	qicai
更改	genggai
附赠品	fuzengpin
血拼	xiepin
折扣	zhekou
屁股	pigu
物质	wuzhi
银行	yinxing
漫画	manhua
纾解	shujie
源头	yuantou
取决于	qujueyu
配角	peijiao
小说	xiaoshuo
呈现	chengxian
仇恨	chouhen
沟通	goutong
天文数字	tianwenshuzi
知心	zhixin
深陷	shenxian
侵蚀	qinshi
考过	kaoguo
两件事	liangjianshi
全民	quanmin
循著	xunzhu
卸下	xiexia
包袱	baofu
泉源	quanyuan
蹲下	dunxia
思绪	sixu
身心	shenxin
名为	mingwei
应要	yingyao
修改	xiugai
编在	bianzai
附赠	fuzeng
热汤	retang
熬夜	aoye
送来	songlai
前者	qianzhe
后者	houzhe
小玩意儿	xiaowanyier
搜寻	souxun
树荫	shuyin
口角	koujiao
知足	zhizu
外交官	waijiaoguan
表哥	biaoge
爷爷	yeye
形容	xingrong
笑话	xiaohua
刺激	ciji
级级	jiji
杀怪	shaguai
看不起	kanbuqi
不争气	buzhengqi
商机	shangji
报纸	baozhi
政府	zhengfu
经济	jingji
考完	kaowan
转换	zhuanhuan
听讲	tingjiang
课堂	ketang
脱裤子	tuokuzi
老哥	laoge
失眠	shimian
日记	riji
存进	cunjin
打完	dawan
寻获	xunhuo
挥洒	huisa
球场	qiuchang
交友	jiaoyou
重点	zhongdian
逛街	guangjie
浪费时间	langfeishijian
战利品	zhanlipin
管道	guandao
增进感情	zengjinganqing
建筑	jianzhu
来自	laizi
打气	daqi
来源	laiyuan
精采	jingcai
拮据	jieju
居士	jushi
告终	gaozhong
当做	dangzuo
动词	dongci
看不见	kanbujian
劝说	quanshuo
叹气	tanqi
路边摊	lubiantan
散散步	sansanbu
小吃店	xiaochidian
闲聊	xianliao
面试	mianshi
设法	shefa
流失	liushi
虫儿	chonger
枝头	zhitou
鸣叫	mingjiao
纪录	jilu
打破	dapo
拿笔	nabi
写出	xiechu
绘画	huihua
天马行空	tianmaxingkong
甘苦	ganku
亲子	qinzi
职场	zhichang
哲理	zheli
话题	huati
静观	jingguan
啼叫	tijiao
自得	zide
鱼群	yuqun
成绩单	chengjidan
成份	chengfen
人心	renxin
西餐厅	xicanting
郊游	jiaoyou
午餐	wucan
带去	daiqu
升学压力	shengxueyali
搞笑	gaoxiao
儿女	ernv
影响力	yingxiangli
例子	lizi
乐事	leshi
跳楼	tiaolou
烧炭	shaotan
走走	zouzou
哀怨	aiyuan
病人	bingren
抽空去	choukongqu
笑靥	xiaoye
爷爷奶奶	yeyenainai
良方	liangfang
涌上来	yongshanglai
面纸	mianzhi
逗得	doude
擦擦	caca
眼泪	yanlei
隐藏	yincang
上篮	shanglan
篮球场	lanqiuchang
重获	zhonghuo
猛兽	mengshou
切入	qieru
汗珠	hanzhu
解开	jiekai
任务	renwu
漫延	manyan
开来	kailai
摸著	mozhu
羽绒	yurong
闯出	chuangchu
气味	qiwei
晕眩	yunxuan
得要	deyao
苦水	kushui
肉干	rougan
讲义	jiangyi
咽下	yanxia
渲泄	xuanxie
笑颜	xiaoyan
流下	liuxia
泪水	leishui
光点	guangdian
破壳	poke
历练	lilian
点燃	dianran
投不进	toubujin
耍宝	shuabao
逗我	douwo
投球	touqiu
诀窍	jueqiao
品尝	pinchang
母亲	muqin
外太空	waitaikong
散散心	sansanxin
疾病	jibing
窒息	zhixi
让你玩	rangniwan
玩到	wandao
正常人	zhengchangren
电动	diandong
为止	weizhi
模型	moxing
人车	renche
可寻	kexun
鼎沸	dingfei
喧嚣	xuanxiao
封闭	fengbi
抱持	baochi
好玩	haowan
夸张	kuazhang
填饱	tianbao
味觉	weijue
歌词	geci
打消	daxiao
肚子	duzi
名言	mingyan
藏著	cangzhu
想聚	xiangju
人事	renshi
吸取	xiqu
赋予	fuyu
满足	manzu
败坏	baihuai
天堂	tiantang
事都	shidu
相聚	xiangju
透顶	touding
失意	shiyi
懊恼	aonao
取代	qudai
洞房花烛	dongfanghuazhu
古时候	gushihou
科技	keji
落花	luohua
放慢	fangman
水面	shuimian
玩球	wanqiu
向著	xiangzhu
排出	paichu
沉著	chenzhu
提不起	tibuqi
开怀	kaihuai
阻碍	zuai
晚风	wanfeng
享乐	xiangle
闪过	shanguo
联络	lianluo
叶瓣	yeban
橘黄色	juhuangse
微风	weifeng
叶片	yepian
告别	gaobie
妇女	funv
产龄	chanling
个数	geshu
婴儿	yinger
下滑	xiahua
现象	xianxiang
全球	quanqiu
缓地	huandi
生育率	shengyulv
推测	tuice
不变	bubian
状态	zhuangtai
战争时代	zhanzhengshidai
比率	bilv
增多	zengduo
医疗	yiliao
数量	shuliang
孩子	haizi
人数	renshu
数据	shuju
统计数据	tongjishuju
看得出来	kandechulai
情形	qingxing
统计表	tongjibiao
转变	zhuanbian
人口	renkou
增加	zengjia
降到	jiangdao
迁变	qianbian
女性	nvxing
统计图	tongjitu
反倒	fandao
向下	xiangxia
总数	zongshu
资料	ziliao
促成	cucheng
膨胀	pengzhang
法规	fagui
能于	nengyu
争荣	zhengrong
生小孩	shengxiaohai
高学历	gaoxueli
堕胎	duotai
怀孕	huaiyun
危机	weiji
系统	xitong
结婚年龄	jiehunnianling
结婚	jiehun
注目	zhumu
成人	chengren
转移	zhuanyi
企业	qiye
市场	shichang
花钱	huaqian
购物	gouwu
领取	lingqu
不成	bucheng
应变	yingbian
全球化	quanqiuhua
注重	zhuzhong
指导	zhidao
急变	jibian
提前准备	tiqianzhunbei
肯定	kending
政策	zhengce
呼吁	huyu
全人类	quanrenlei
称之为	chengzhiwei
泼出去	pochuqu
刻版	keban
女孩	nvhai
男性	nanxing
作用	zuoyong
超过	chaoguo
独立	duli
货币	huobi
移民	yimin
外籍人	waijiren
法律	falv
本地人	bendiren
语言	yuyan
文化	wenhua
院子	yuanzi
房子	fangzi
缴税	jiaoshui
金额	jine
进行	jinxing
衍生	yansheng
养妻	yangqi
托儿所	tuoersuo
看顾	kangu
热门	remen
挣钱	zhengqian
担当	dandang
活儿	huoer
厨房	chufang
无人	wuren
移转到	yizhuandao
就业	jiuye
提供	tigong
极端派	jiduanpai
社会主义者	shehuizhuyizhe
煽动	shandong
福利制度	fulizhidu
补贴	butie
停滞	tingzhi
生产力	shengchanli
倾向	qingxiang
出生率	chushenglv
称做	chengzuo
改善	gaishan
人口数	renkoushu
工作量	gongzuoliang
加重	jiazhong
资讯	zixun
推出	tuichu
失业	shiye
增长率	zengchanglv
粮食	liangshi
离婚	lihun
教育费	jiaoyufei
发达	fada
避孕	biyun
制定	zhiding
生太	shengtai
少生	shaosheng
子女	zinv
危害	weihai
国民	guomin
因应	yinying
财政支出	caizhengzhichu
破产	pochan
过有	guoyou
扶养	fuyang
补助	buzhu
脸色	lianse
老人	laoren
费用	feiyong
帮手	bangshou
受过	shouguo
生意	shengyi
上升	shangsheng
反观	fanguan
告知	gaozhi
举办	juban
风险	fengxian
地将	dijiang
缴付	jiaofu
只限	zhixian
新增	xinzeng
报告	baogao
大量	daliang
表示	biaoshi
出率	chulv
普遍现象	pubianxianxiang
家事	jiashi
男人	nanren
传统	chuantong
电视新闻	dianshixinwen
婚姻	hunyin
老婆	laopo
成立	chengli
公司	gongsi
打赢	daying
武器	wuqi
没钱	meiqian
温室效应	wenshixiaoying
买房子	maifangzi
需求量	xuqiuliang
产品	chanpin
观点	guandian
上司	shangsi
信赖	xinlai
稳定度	wendingdu
辞职	cizhi
化妆	huazhuang
技巧	jiqiao
彩妆师	caizhuangshi
问时	wenshi
造形	zaoxing
漏掉	loudiao
考量	kaoliang
同心	tongxin
要化	yaohua
赞许	zanxu
合群	hequn
电视节目	dianshijiemu
通告	tonggao
接到	jiedao
工作人员	gongzuorenyuan
宠物	chongwu
小猫	xiaomao
出租	chuzu
主意	zhuyi
支持	zhichi
参观	canguan
放假	fangjia
好菜	haocai
夜市	yeshi
小吃	xiaochi
无可	wuke
电话	dianhua
泡汤	paotang
回去	huiqu
计划	jihua
想见	xiangjian
王品	wangpin
餐厅	canting
要去	yaoqu
见面	jianmian
说完	shuowan
裤子	kuzi
文平	wenping
帽子	maozi
黄色	huangse
红色	hongse
出去玩	chuquwan
书店	shudian
答应	daying
牛仔裤	niuziku
电话号码	dianhuahaoma
写信给	xiexingei
安排	anpai
逛一逛	guangyiguang
认错	rencuo
蓝色	lanse
白色	baise
抽空	choukong
拜访	baifang
大哥	dage
诚品	chengpin
机票	jipiao
来回	laihui
配著	peizhu
天蓝色	tianlanse
咬破	yaopo
衬衫	chenshan
新光	xinguang
等不及	dengbuji
放够	fanggou
寄给	jigei
邮票	youpiao
邮局	youju
地址	dizhi
收到	shoudao
飞机场	feijichang
停车场	tingchechang
欢迎	huanying
划船	huachuan
行程	xingcheng
行李	xingli
逛完	guangwan
头发	toufa
期地	qidi
床上	chuangshang
干嘛	ganma
打工	dagong
考虑一下	kaolvyixia
参考	cankao
名古屋	mingguwu
饭馆	fanguan
牛肉	niurou
听的歌	tingdege
可看	kekan
跳舞	tiaowu
介绍	jieshao
坐公车	zuogongche
渔人	yuren
码头	matou
电影	dianying
学院	xueyuan
车祸	chehuo
爱人	airen
分手	fenshou
公寓	gongyu
弟弟	didi
表达	biaoda
兄弟	xiongdi
劝告	quangao
打喷嚏	dapenti
喷替	penti
劝导	quandao
教养	jiaoyang
礼貌	limao
目嚏	muti
回不完	huibuwan
生下	shengxia
文学	wenxue
保重	baozhong
庆祝	qingzhu
晚饭	wanfan
上班	shangban
流利	liuli
网路	wanglu
广告	guanggao
部落	buluo
作文	zuowen
地教	dijiao
大学生	daxuesheng
买好	maihao
房屋	fangwu
老实	laoshi
买手机	maishouji
自选	zixuan
邻居	linju
抱出去	baochuqu
求救	qiujiu
下班	xiaban
宠物医院	chongwuyiyuan
车门	chemen
帮别人	bangbieren
姐妹	jiemei
作工	zuogong
报恩	baoen
功德	gongde
想得到	xiangdedao
表姊妹	biaozimei
晒太阳	shaitaiyang
车站	chezhan
预约	yuyue
做饭	zuofan
相片	xiangpian
座椅	zuoyi
咖啡	kafei
出租车	chuzuche
对面	duimian
推荐	tuijian
咖啡馆	kafeiguan
森林公园	senlingongyuan
皮夹克	pijiake
认得	rende
眼睛	yanjing
尝尝	changchang
好看	haokan
橘红色	juhongse
粉红色	fenhongse
背包	beibao
难看	nankan
绿色	lvse
认出	renchu
太太	taitai
上有	shangyou
上衣	shangyi
名字	mingzi
老街	laojie
淡水	danshui
住在一起	zhuzaiyiqi
主公	zhugong
照片	zhaopian
爱情	aiqing
听话	tinghua
坏孩子	huaihaizi
不动	budong
喝著	hezhu
牛奶	niunai
老地	laodi
奶奶	nainai
申请表	shenqingbiao
提得	tide
申请	shenqing
服务员	fuwuyuan
吓一跳	xiayitiao
买单	maidan
做得好	zuodehao
配合	peihe
围著	weizhu
煮饭	zhufan
洗衣服	xiyifu
奔波	benbo
仆人	puren
晓得	xiaode
做菜	zuocai
搬来	banlai
不来	bulai
消息	xiaoxi
让我学	rangwoxue
赚来	zhuanlai
超多	chaoduo
照相机	zhaoxiangji
新车	xinche
学费	xuefei
我力	woli
课文	kewen
体育馆	tiyuguan
地点	didian
找有	zhaoyou
肚子饿	duzie
中心	zhongxin
地玩	diwan
准舞	zhunwu
晚会	wanhui
演讲	yanjiang
发传单	fachuandan
做广告	zuoguanggao
剑术	jianshu
原住民	yuanzhumin
历史	lishi
月台	yuetai
部分	bufen
冰店	bingdian
过瘾	guoyin
总算	zongsuan
芒果	mangguo
冰是	bingshi
芒果汁	mangguozhi
破掉	podiao
摊位	tanwei
事件	shijian
选写	xuanxie
同事	tongshi
杀价	shajia
摆摊	baitan
买不到	maibudao
买到	maidao
商品	shangpin
打给	dagei
商店	shangdian
客气	keqi
没卖	meimai
飞到	feidao
店员	dianyuan
客人	keren
热情	reqing
要付	yaofu
特价	tejia
唱片	changpian
文具	wenju
点心	dianxin
杂志	zazhi
看得懂	kandedong
卖东西	maidongxi
鞋子	xiezi
女人	nvren
胶水	jiaoshui
跟我走	genwozou
牛肉面	niuroumian
密码	mima
还给	huangei
一层楼	yicenglou
钟头	zhongtou
考考试	kaokaoshi
文法	wenfa
生词	shengci
内容	neirong
转机	zhuanji
搭公车	dagongche
利用	liyong
质料	zhiliao
坐飞机	zuofeiji
绿岛	lvdao
著者	zhuzhe
打折	dazhe
朋友家	pengyoujia
计程车	jichengche
河跟园	hegenyuan
公车	gongche
交通	jiaotong
口音	kouyin
难听	nanting
听得懂	tingdedong
高粱酒	gaoliangjiu
划得来	huadelai
铁塔	tieta
博物馆	bowuguan
大楼	dalou
可做	kezuo
动物园	dongwuyuan
看来	kanlai
见识	jianshi
男朋友	nanpengyou
旅行团	lvxingtuan
沙漠	shamo
森林	senlin
事故	shigu
核子	hezi
坐火车	zuohuoche
核能	heneng
电厂	dianchang
军人	junren
防守	fangshou
白酒	baijiu
大学老师	daxuelaoshi
油画	youhua
课程	kecheng
主题	zhuti
算钱	suanqian
用书	yongshu
现金	xianjin
交换	jiaohuan
发音	fayin
了坏	lehuai
补考	bukao
理论	lilun
解释	jieshi
举手	jushou
金融风暴	jinrongfengbao
采取	caiqu
说错	shuocuo
对学	duixue
要动	yaodong
出玩	chuwan
学生会	xueshenghui
玩电脑	wandiannao
听考	tingkao
大考	dakao
每隔	meige
体育课	tiyuke
才学	caixue
气氛	qifen
办公室	bangongshi
跟写	genxie
大学教授	daxuejiaoshou
没变	meibian
教人	jiaoren
语言学	yuyanxue
母语	muyu
教法	jiaofa
重视	zhongshi
实用	shiyong
用学	yongxue
说法	shuofa
租房子	zufangzi
适应	shiying
要放	yaofang
学好	xuehao
交往	jiaowang
上网	shangwang
借给	jiegei
小妹	xiaomei
科学系	kexuexi
研究所	yanjiusuo
想出	xiangchu
靴子	xuezi
奶茶	naicha
太白	taibai
肩膀	jianbang
皮肤	pifu
衣著	yizhu
棕色	zongse
时尚	shishang
嘴唇	zuichun
鼻子	bizi
手机号码	shoujihaoma
外长	waichang
辣妹	lamei
猫咪	maomi
求求	qiuqiu
查出	chachu
包裹	baoguo
通知	tongzhi
破碎	posui
没收	meishou
个面	gemian
美女	meinv
下过	xiaguo
五官	wuguan
出汗	chuhan
初恋	chulian
写信	xiexin
恋爱	lianai
夜店	yedian
公主	gongzhu
女神	nvshen
台湾人	taiwanren
不理	buli
睡醒	shuixing
挤死	jisi
跟比	genbi
赶说	ganshuo
写标	xiebiao
记得住	jidezhu
作梦	zuomeng
梦到	mengdao
跳越	tiaoyue
跳跑	tiaopao
逃跑	taopao
飞行	feixing
跟上来	genshanglai
抓走	zhuazou
吓了一跳	xialeyitiao
醒来	xinglai
速度	sudu
交新	jiaoxin
拉著	lazhu
两条船	liangtiaochuan
女朋友	nvpengyou
脚踏	jiaota
完书	wanshu
没走	meizou
做梦	zuomeng
剧情	juqing
魅力	meili
戏剧	xiju
留学生	liuxuesheng
剧本	juben
上传	shangchuan
机器	jiqi
找钱	zhaoqian
人分	renfen
需要的话	xuyaodehua
下雨	xiayu
民族	minzu
观众	guanzhong
理由	liyou
下课后	xiakehou
音乐剧	yinleju
演戏	yanxi
发挥	fahui
语法	yufa
脚本	jiaoben
写完	xiewan
检查一下	jianchayixia
现场	xianchang
好玩儿	haowaner
情人	qingren
部份	bufen
讲道理	jiangdaoli
服饰	fushi
月亮代表	yueliangdaibiao
遇见	yujian
选歌	xuange
文字	wenzi
跳来跳去	tiaolaitiaoqu
放鞭炮	fangbianpao
操场	caochang
走来	zoulai
想用	xiangyong
说服	shuofu
登记	dengji
摊子	tanzi
冷水	lengshui
名模	mingmo
光下	guangxia
女孩子	nvhaizi
决意	jueyi
接问	jiewen
不买	bumai
天暗	tianan
屏息	pingxi
辞典	cidian
昏倒	hundao
价格	jiage
柜台	guitai
结帐	jiezhang
服务态度	fuwutaidu
付钱	fuqian
新买	xinmai
仿冒品	fangmaopin
撕掉	sidiao
花生	huasheng
期末考	qimokao
考得	kaode
全心	quanxin
回应	huiying
勉强	mianqiang
表情	biaoqing
服装店	fuzhuangdian
意愿	yiyuan
服务生	fuwusheng
打错	dacuo
发票	fapiao
承认	chengren
写著	xiezhu
叫门	jiaomen
块钱	kuaiqian
用量	yongliang
牌子	paizi
了买	lemai
飞机票	feijipiao
用光	yongguang
恤的店	xudedian
分开	fenkai
台币	taibi
买开	maikai
薪水	xinshui
汽车	qiche
质量	zhiliang
店品	dianpin
机场	jichang
不太会	butaihui
爬山	pashan
没来	meilai
面线	mianxian
臭豆腐	choudoufu
鱿鱼	youyu
种类	zhonglei
问好	wenhao
转告	zhuangao
喝一杯	heyibei
打个招呼	dagezhaohu
料理	liaoli
换成	huancheng
我学	woxue
敬业精神	jingyejingshen
新知	xinzhi
示范	shifan
教学方式	jiaoxuefangshi
创新性	chuangxinxing
进得	jinde
成高	chenggao
问问	wenwen
电梯	dianti
楼梯	louti
会话	huihua
感恩	ganen
教师	jiaoshi
担任	danren
地连	dilian
名词	mingci
起到	qidao
有效率	youxiaolv
提议	tiyi
上到	shangdao
体谅	tiliang
辜负	gufu
老人家	laorenjia
班理	banli
听不懂	tingbudong
记著	jizhu
案例	anli
课程内容	kechengneirong
旅馆	lvguan
解决方案	jiejuefangan
浅见	qianjian
长辈	changbei
说出	shuochu
地位	diwei
猪血	zhuxie
香菜	xiangcai
大肠	dachang
香味	xiangwei
虾球	xiaqiu
虾子	xiazi
罐头	guantou
咕咾肉	gulaorou
春卷	chunjuan
青椒	qingjiao
肉丝	rousi
麻婆豆腐	mapodoufu
受欢迎	shouhuanying
白饭	baifan
胃部	weibu
含有	hanyou
肠粉	changfen
饮茶	yincha
虾饺	xiajiao
猪肠	zhuchang
叉烧	chashao
小笼包	xiaolongbao
芋角	yujiao
蛋塔	danta
豆腐花	doufuhua
芋头	yutou
出热	chure
青蛙	qingwa
素菜	sucai
吃素	chisu
风鸡	fengji
鸡肉	jirou
青菜	qingcai
显出	xianchu
油腻	youni
口味	kouwei
泡菜	paocai
辣酱	lajiang
萝卜	luobu
外国人	waiguoren
闻到	wendao
放心	fangxin
饭馆儿	fanguaner
著马	zhuma
无袖	wuxiu
客厅	keting
额头	etou
词汇	cihui
重任	zhongren
得意	deyi
限制	xianzhi
可忘	kewang
收钱	shouqian
基金会	jijinhui
姊姊	zizi
家具	jiaju
租费	zufei
划算	huasuan
地区	diqu
酒馆	jiuguan
提到	tidao
为主	weizhu
屋子	wuzi
农村	nongcun
具有	juyou
小商店	xiaoshangdian
姊妹	zimei
龟苓膏	guilinggao
烧烤	shaokao
鸡蛋	jidan
玩儿	waner
来学	laixue
打字	dazi
房东	fangdong
房租	fangzu
地铁	ditie
省钱	shengqian
女儿	nver
押金	yajin
月租	yuezu
好话	haohua
电视机	dianshiji
花园	huayuan
桌书	zhuoshu
冷气	lengqi
水电费	shuidianfei
公馆	gongguan
空气	kongqi
学舍	xueshe
国际学舍	guojixueshe
管理员	guanliyuan
浴室	yushi
衣柜	yigui
气候	qihou
地房	difang
买得起	maideqi
面积	mianji
洗澡	xizao
手续费	shouxufei
蛋花汤	danhuatang
包子	baozi
吹拭	chuishi
日落	riluo
地摊	ditan
健行	jianxing
坐船	zuochuan
过河	guohe
了信	lexin
写给	xiegei
钓鱼	diaoyu
长袖	changxiu
野餐	yecan
护照	huzhao
签发	qianfa
搭乘	dacheng
女王	nvwang
试试看	shishikan
高铁	gaotie
育养	yuyang
没满	meiman
年数	nianshu
事业	shiye
洋基队	yangjidui
投手	toushou
王牌	wangpai
亲哥哥	qingege
有点像	youdianxiang
改错	gaicuo
给养	geiyang
回报	huibao
帮不上	bangbushang
做生意	zuoshengyi
委托	weituo
杀死	shasi
静听	jingting
缘分	yuanfen
尽责	jinze
做有	zuoyou
餐具	canju
用餐	yongcan
没怪	meiguai
远视	yuanshi
买货	maihuo
货场	huochang
现代人	xiandairen
景气	jingqi
好消息	haoxiaoxi
政桓	zhenghuan
野柳	yeliu
就下	jiuxia
外衣	waiyi
放好	fanghao
舅舅	jiujiu
订位	dingwei
火锅	huoguo
棒极了	bangjile
教学中心	jiaoxuezhongxin
开得	kaide
包里	baoli
环岛	huandao
故宫	gugong
水煎包	shuijianbao
逛逛	guangguang
饺子	jiaozi
文强	wenqiang
地学	dixue
外劳	wailao
空军	kongjun
的哥	dege
打招呼	dazhaohu
唱出	changchu
完歌	wange
无尾熊	wuweixiong
转车	zhuanche
火车站	huochezhan
火车	huoche
估计	guji
很精采	henjingcai
足球比赛	zuqiubisai
没学	meixue
报了名	baoleming
色香味	sexiangwei
文物	wenwu
看完	kanwan
保证书	baozhengshu
包包	baobao
胖子	pangzi
眼界	yanjie
我姐	wojie
撞到	zhuangdao
镜子	jingzi
瘦身	shoushen
地球	diqiu
太空	taikong
基地	jidi
情心	qingxin
蟑螂	zhanglang
龙猫	longmao
家屋	jiawu
寒假	hanjia
外公	waigong
小岛	xiaodao
超人	chaoren
开场	kaichang
男主角	nanzhujiao
工夫	gongfu
地演	diyan
功夫	gongfu
华人	huaren
看腻	kanni
外婆	waipo
小男孩	xiaonanhai
姑姑	gugu
歌名	geming
来生	laisheng
相爱	xiangai
连著	lianzhu
相配	xiangpei
情侣	qinglv
蝴蝶	hudie
学堂	xuetang
情景	qingjing
经得起	jingdeqi
连接	lianjie
母狮	mushi
撒娇	sajiao
流泪	liulei
公狮	gongshi
伤心地	shangxindi
卡通片	qiatongpian
动脑筋	dongnaojin
被害人	beihairen
证件	zhengjian
猜中	caizhong
对比	duibi
男孩	nanhai
儿子	erzi
哭声	kusheng
逮捕	daibu
人员	renyuan
学舞	xuewu
跳出去	tiaochuqu
失落	shiluo
佩服	peifu
送达	songda
钟情	zhongqing
未婚妻	weihunqi
女主角	nvzhujiao
假装	jiazhuang
坏心	huaixin
改过	gaiguo
个子	gezi
苹果	pingguo
睡掉	shuidiao
没死	meisi
翻译	fanyi
酒吧	jiuba
婚礼	hunli
订婚	dinghun
拉面	lamian
饮食	yinshi
蔬菜	shucai
校友	xiaoyou
校长	xiaochang
啦啦队	laladui
经纪人	jingjiren
演唱会	yanchanghui
距离感	juligan
略带	lvedai
整体	zhengti
业界	yejie
场面	changmian
人士	renshi
听听看	tingtingkan
吉他手	jitashou
招生	zhaosheng
家长	jiachang
推行	tuixing
披得	pide
败裂	bailie
站著	zhanzhu
排队	paidui
讲话	jianghua
演讲时	yanjiangshi
举行	juxing
篮球比赛	lanqiubisai
演唱	yanchang
变热	bianre
连络	lianluo
社长	shechang
风度	fengdu
土王	tuwang
倭人	weiren
厅里	tingli
女同学	nvtongxue
宣告	xuangao
暗恋	anlian
了有	leyou
坏蛋	huaidan
丢脸	diulian
活该	huogai
长长	changchang
游会	youhui
迷人	miren
台语	taiyu
约会	yuehui
歌唱	gechang
小气鬼	xiaoqigui
大方	dafang
蛮帅	manshuai
请吃	qingchi
杯酒	beijiu
大好人	dahaoren
改天	gaitian
卖菜	maicai
太重	taizhong
爱护动物	aihudongwu
保养	baoyang
会面	huimian
当心	dangxin
料到	liaodao
硕士	shuoshi
房事	fangshi
吃光	chiguang
打网球	dawangqiu
弹钢琴	dangangqin
买东	maidong
客客气气	kekeqiqi
没读	meidu
推销	tuixiao
看用	kanyong
祖父	zufu
钻石	zuanshi
没念	meinian
天主	tianzhu
天父	tianfu
圣经	shengjing
根源	genyuan
描写	miaoxie
认字	renzi
小组	xiaozu
足球	zuqiu
足球队	zuqiudui
记者	jizhe
主管	zhuguan
再赢	zaiying
目表	mubiao
模特儿	moteer
弄得好	nongdehao
公平	gongping
将军	jiangjun
当兵	dangbing
军粮	junliang
打仗	dazhang
军团	juntuan
委员	weiyuan
领导	lingdao
注销	zhuxiao
实力	shili
变坏	bianhuai
军队	jundui
绘本	huiben
星空	xingkong
展览	zhanlan
作家	zuojia
小本书	xiaobenshu
西游记	xiyouji
悟空	wukong
总用	zongyong
功力	gongli
观音	guanyin
电视剧	dianshiju
教事	jiaoshi
店里	dianli
本本	benben
学学	xuexue
地好	dihao
作者	zuozhe
讲故事	jianggushi
会用	huiyong
穷人	qiongren
大陆	dalu
领导人	lingdaoren
老百姓	laobaixing
身分证	shenfenzheng
偷跑	toupao
信神	xinshen
晚睡	wanshui
寝室	qinshi
传出	chuanchu
关灯	guandeng
来信	laixin
埋怨	maiyuan
室友	shiyou
颇为	powei
指给	zhigei
没事	meishi
没去	meiqu
喝酒	hejiu
警察局	jingchaju
来接	laijie
钱包	qianbao
选手	xuanshou
部活	buhuo
按摩	anmo
每学期	meixueqi
时程	shicheng
操课	caoke
考前	kaoqian
坏处	huaichu
学弟	xuedi
旅行社	lvxingshe
姓名	xingming
确认	queren
空房间	kongfangjian
铁门	tiemen
水费	shuifei
洗手间	xishoujian
电费	dianfei
冰箱	bingxiang
脚车	jiaoche
跟住	genzhu
舞会	wuhui
交通站	jiaotongzhan
大床	dachuang
厕所	cesuo
超级市场	chaojishichang
铁路	tielu
离家	lijia
高速公路	gaosugonglu
公路	gonglu
看吧	kanba
付款	fukuan
租金	zujin
便利店	bianlidian
超市	chaoshi
空房	kongfang
有户	youhu
晒衣服	shaiyifu
洗衣机	xiyiji
想住	xiangzhu
招待	zhaodai
衣架	yijia
车库	cheku
书架	shujia
回信	huixin
客房	kefang
费心	feixin
体贴	titie
规定	guiding
先付	xianfu
中点	zhongdian
刀叉	daocha
新房子	xinfangzi
洗澡间	xizaojian
冷机	lengji
光碟	guangdie
素食	sushi
便服	bianfu
餐馆	canguan
下楼	xialou
寺庙	simiao
叉叉	chacha
男友	nanyou
追球	zhuiqiu
办公	bangong
新生	xinsheng
结了婚	jielehun
人马	renma
说好	shuohao
和室	heshi
日本式	ribenshi
蛋糕	dangao
做来	zuolai
指教	zhijiao
外祖母	waizumu
母子情	muziqing
举酒	jujiu
乐友	leyou
老套	laotao
仁者	renzhe
智者	zhizhe
俗话	suhua
散去	sanqu
诗人	shiren
下得	xiade
求婚	qiuhun
减肥	jianfei
淡水河	danshuihe
车行道	chexingdao
预备	yubei
埋头	maitou
嫁给	jiagei
补校	buxiao
小鸡	xiaoji
火星	huoxing
早饭	zaofan
累得	leide
袜子	wazi
入睡	rushui
地理	dili
公车上	gongcheshang
果汁	guozhi
面包	mianbao
日文	riwen
买票	maipiao
电影院	dianyingyuan
方子	fangzi
学校地址	xuexiaodizhi
没到	meidao
来来	lailai
两本书	liangbenshu
红酒	hongjiu
买国	maiguo
宿舍	sushe
上车	shangche
台生	taisheng
面见	mianjian
叫住	jiaozhu
进车	jinche
送到	songdao
爬著	pazhu
小毛	xiaomao
往前面	wangqianmian
外话	waihua
季节	jijie
地谈	ditan
时侯	shihou
地下铁	dixiatie
告所	gaosuo
问路	wenlu
大卫	dawei
中友	zhongyou
百货	baihuo
文书	wenshu
拍照片	paizhaopian
高雄	gaoxiong
写到	xiedao
翘课	qiaoke
共公	gonggong
架构	jiagou
健身房	jianshenfang
奖学金	jiangxuejin
请假	qingjia
赶到	gandao
手表	shoubiao
坐下	zuoxia
不吃	buchi
找空	zhaokong
闹钟	naozhong
刷牙	shuaya
洗脸	xilian
睡到	shuidao
跳到	tiaodao
的士	deshi
课室	keshi
跳著	tiaozhu
听试	tingshi
了好	lehao
先学	xianxue
烤肉	kaorou
暖气	nuanqi
玩著	wanzhu
纪念	jinian
躲到	duodao
淋雨	linyu
汽水	qishui
吃水果	chishuiguo
午饭	wufan
会考	huikao
玩吧	wanba
简讯	jianxun
化妆品	huazhuangpin
棒球赛	bangqiusai
啤酒	pijiu
喝啤酒	hepijiu
酒量	jiuliang
卧房	wofang
家玩	jiawan
小王	xiaowang
请进来	qingjinlai
喷过	penguo
喷得	pende
蔬果	shuguo
农药	nongyao
有机	youji
过度	guodu
菜药	caiyao
买菜	maicai
诉取	suqu
赔偿	peichang
忍耐	rennai
要写	yaoxie
背景	beijing
声调	shengdiao
该不该	gaibugai
传给	chuangei
自我介绍	ziwojieshao
冷漠	lengmo
买错	maicuo
算了	suanle
回想到	huixiangdao
联系	lianxi
小张	xiaozhang
约定	yueding
误会	wuhui
小钱	xiaoqian
拍卖	paimai
脸皮	lianpi
分校	fenxiao
观光	guanguang
大介	dajie
游泳池	youyongchi
科系	kexi
项目	xiangmu
酒家女	jiujianv
卖身	maishen
酒店	jiudian
下跌	xiadie
股市	gushi
医学系	yixuexi
休学	xiuxue
理解	lijie
美金	meijin
好赚	haozhuan
里学	lixue
实习	shixi
学习成绩	xuexichengji
一毛钱	yimaoqian
技能	jineng
较长时间	jiaochangshijian
不准	buzhun
趴到	padao
得去	dequ
指责	zhize
笑笑	xiaoxiao
东聊	dongliao
无证据	wuzhengju
做法	zuofa
怀疑	huaiyi
证据	zhengju
乐意	leyi
经验丰富	jingyanfengfu
听听	tingting
邮件	youjian
手册	shouce
本手册	benshouce
放进	fangjin
负面影响	fumianyingxiang
度量	duliang
偷走	touzou
否安	fouan
看错	kancuo
保护性	baohuxing
关键时刻	guanjianshike
摆出	baichu
手段	shouduan
女友	nvyou
可靠	kekao
看出	kanchu
请原谅	qingyuanliang
政治家	zhengzhijia
全国	quanguo
电子邮件	dianziyoujian
念完	nianwan
秘诀	mijue
判定	panding
两难	liangnan
对立	duili
共识	gongshi
客观性	keguanxing
研讨会	yantaohui
场合	changhe
民众	minzhong
机关	jiguan
单位	danwei
隧道	suidao
收入	shouru
皮肤癌	pifuai
畸形儿	jixinger
臭氧层	chouyangceng
破洞	podong
紫外线	ziwaixian
观光事业	guanguangshiye
比如	biru
生态	shengtai
环境污染	huanjingwuran
挽救	wanjiu
能源	nengyuan
废气	feiqi
兴建	xingjian
私人	siren
商业	shangye
废弃物	feiqiwu
灾害	zaihai
房地	fangdi
水质	shuizhi
动植物	dongzhiwu
还用	huanyong
环境保护	huanjingbaohu
无视	wushi
生鱼片	shengyupian
寿司	shousi
指味	zhiwei
家常菜	jiachangcai
放味增	fangweizeng
清汤	qingtang
海带	haidai
名校	mingxiao
扩大	kuoda
进化	jinhua
需求	xuqiu
想养	xiangyang
要养	yaoyang
养主	yangzhu
死掉	sidiao
价值	jiazhi
说著	shuozhu
空养	kongyang
都市生活	dushishenghuo
市民	shimin
换回来	huanhuilai
一家人	yijiaren
打扰	darao
理性	lixing
可让	kerang
看成	kancheng
玩够	wangou
弃养	qiyang
比买	bimai
伤脑筋	shangnaojin
医疗费	yiliaofei
送走	songzou
注意力	zhuyili
教育界	jiaoyujie
外文	waiwen
功能	gongneng
具备	jubei
创新	chuangxin
教育规划	jiaoyuguihua
减化	jianhua
学该	xuegai
单方	danfang
贵师	guishi
退休	tuixiu
口琴	kouqin
刺刺	cici
点子	dianzi
抬不	taibu
败家子	baijiazi
起头	qitou
店长	dianchang
病患	binghuan
太极拳	taijiquan
家园	jiayuan
出院	chuyuan
医术	yishu
规划	guihua
环游世界	huanyoushijie
艺术馆	yishuguan
人选	renxuan
解决办法	jiejuebanfa
专门	zhuanmen
夫妻关系	fuqiguanxi
集中	jizhong
职业妇女	zhiyefunv
生子	shengzi
开除	kaichu
家庭主妇	jiatingzhufu
洗衣	xiyi
保母	baomu
外遇	waiyu
暴力	baoli
杂事	zashi
重男轻女	zhongnanqingnv
公理	gongli
女强人	nvqiangren
舍得	shede
离职	lizhi
医学	yixue
提高	tigao
技术	jishu
继父	jifu
原则	yuanze
主义	zhuyi
选举	xuanju
推广	tuiguang
男女	nannv
替代	tidai
人工	rengong
制造	zhizao
深层	shenceng
涉及	sheji
执行	zhixing
实施	shishi
馆子	guanzi
节省	jiesheng
运动鞋	yundongxie
动动	dongdong
跑步	paobu
带上	daishang
纺织业	fangzhiye
劳工市场	laogongshichang
施行	shixing
职务	zhiwu
游学	youxue
河有段	heyouduan
可待	kedai
成疾	chengji
裁员	caiyuan
海啸	haixiao
金融	jinrong
过渡期	guoduqi
出口品	chukoupin
优家	youjia
会议	huiyi
可能性	kenengxing
国际	guoji
调薪	diaoxin
休假	xiujia
聘请	pinqing
机械	jixie
全世	quanshi
业务员	yewuyuan
聘为	pinwei
地被	dibei
误人子弟	wurenzidi
开办	kaiban
开玩笑	kaiwanxiao
出席	chuxi
参与	canyu
加班	jiaban
领到	lingdao
贴补	tiebu
缺钱	queqian
伸手	shenshou
创业	chuangye
业务	yewu
客户	kehu
可塑	kesu
妻子	qizi
过对	guodui
上馆子	shangguanzi
单身	danshen
要学	yaoxue
开支	kaizhi
品牌服饰	pinpaifushi
日常用品	richangyongpin
省略	shenglve
能用	nengyong
低潮	dichao
经济周期	jingjizhouqi
企业界	qiyejie
大局	daju
时数	shishu
激增	jizeng
补充	buchong
不合理	buheli
电脑公司	diannaogongsi
保温	baowen
热气	reqi
手机	shouji
威力	weili
情报	qingbao
潜力	qianli
担忧	danyou
骗人	pianren
网络	wangluo
症结所在	zhengjiesuozai
用法	yongfa
妨碍	fangai
导领	daoling
噩梦	emeng
领域	lingyu
作法	zuofa
禁止	jinzhi
玩线	wanxian
著迷	zhumi
管好	guanhao
网际网路	wangjiwanglu
下笔	xiabi
读破	dupo
生花	shenghua
行云流水	xingyunliushui
书卷	shujuan
有神	youshen
阅读	yuedu
营养	yingyang
盐巴	yanba
缴交	jiaojiao
窝著	wozhu
媒体	meiti
花费	huafei
完蛋	wandan
会差	huicha
多媒体	duomeiti
下载	xiazai
谎话	huanghua
网页	wangye
规则	guize
查看	chakan
近视	jinshi
实际	shiji
卖掉	maidiao
自行车	zixingche
先机	xianji
爆炸	baozha
抹杀	mosha
传递	chuandi
途径	tujing
接轨	jiegui
淘汰	taotai
来得	laide
厂长	changchang
抽出	chouchu
回复	huifu
散到	sandao
开窗	kaichuang
污水	wushui
放出	fangchu
邻居们	linjumen
代表人	daibiaoren
签名	qianming
住宅	zhuzhai
排除	paichu
上下班	shangxiaban
积成	jicheng
存到	cundao
闹到	naodao
法庭	fating
办著	banzhu
废水	feishui
停工	tinggong
住民	zhumin
居住	juzhu
睡眠	shuimian
居民	jumin
危险度	weixiandu
全面	quanmian
会会	huihui
市政府	shizhengfu
想吐	xiangtu
弥漫	miman
夜班	yeban
吵死	chaosi
反映	fanying
隔音	geyin
安装	anzhuang
损害	sunhai
闭著	bizhu
排气	paiqi
口罩	kouzhao
罚单	fadan
营运	yingyun
关闭	guanbi
合格	hege
诉求	suqiu
法院	fayuan
穿浮	chuanfu
潜蛙	qianwa
晚班	wanban
代替	daiti
开动	kaidong
遵守	zunshou
基本	jiben
上说	shangshuo
过滤	guolv
烟气	yanqi
放水	fangshui
排水	paishui
水沟	shuigou
法子	fazi
排放	paifang
概念	gainian
地向	dixiang
心声	xinsheng
结合	jiehe
里长	lichang
诉诸	suzhu
市长	shichang
发财	facai
公所	gongsuo
开药	kaiyao
市公所	shigongsuo
化学药品	huaxueyaopin
过滤器	guolvqi
会告	huigao
对策	duice
部门	bumen
音和味	yinhewei
虫子	chongzi
使得	shide
获利	huoli
商量	shangliang
胃口	weikou
头晕	touyun
回覆	huifu
会花	huihua
造出	zaochu
合法	hefa
高医	gaoyi
河堤	hedi
卡车	qiache
液体	yeti
上赔	shangpei
被害者	beihaizhe
癌症	aizheng
摄影机	sheyingji
装影	zhuangying
课题	keti
录下来	luxialai
装影机	zhuangyingji
人权	renquan
录影	luying
发生冲突	fashengchongtu
效率	xiaolv
促进	cujin
教学法	jiaoxuefa
善于	shanyu
保持联系	baochilianxi
打瞌睡	dakeshui
贵校	guixiao
摄影	sheying
皮调	pidiao
处分	chufen
干涉	ganshe
已有	yiyou
询问	xunwen
责感	zegan
变更	biangeng
平台	pingtai
专业	zhuanye
装著	zhuangzhu
不太方	butaifang
范围	fanwei
自由权	ziyouquan
侵害	qinhai
违背	weibei
宪法	xianfa
价值观	jiazhiguan
装不装	zhuangbuzhuang
录影机	luyingji
影机	yingji
变少	bianshao
双亲	shuangqin
带枪	daiqiang
同理	tongli
蜕变	shuibian
心理学	xinlixue
监视	jianshi
霸凌	baling
歹徒	daitu
变态	biantai
侵入	qinru
儿童	ertong
太假	taijia
教式	jiaoshi
标准	biaozhun
避难	binan
小学校长	xiaoxuexiaochang
网站	wangzhan
电影机	dianyingji
关著	guanzhu
要加	yaojia
更糟	gengzao
有益	youyi
就学	jiuxue
地震	dizhen
灾区	zaiqu
地牛	diniu
睡梦中	shuimengzhong
吓坏	xiahuai
地面	dimian
精光	jingguang
火烧	huoshao
捉住	zhuozhu
堆叠	duidie
不务正业	buwuzhengye
小命	xiaoming
保住	baozhu
拿谢	naxie
成名	chengming
打混	dahun
摸鱼	moyu
眼帘	yanlian
棍子	gunzi
制止	zhizhi
娱乐场所	yulechangsuo
磁铁	citie
浓抹	nongmo
淡妆	danzhuang
善行	shanxing
拼补	pinbu
学识	xueshi
海绵	haimian
压迫	yapo
剩下	shengxia
抬起	taiqi
停摆	tingbai
池鱼之殃	chiyuzhiyang
无辜	wugu
遭到	zaodao
神准	shenzhun
沦为	lunwei
只见	zhijian
使出	shichu
验证	yanzheng
占有	zhanyou
塑胶袋	sujiaodai
世界级	shijieji
仅管	jinguan
丑小鸭	chouxiaoya
踪迹	zongji
进到	jindao
版面	banmian
功劳	gonglao
巨人	juren
联想	lianxiang
恶化	ehua
嫌弃	xianqi
罚站	fazhan
午餐时间	wucanshijian
交叉	jiaocha
排列	pailie
推著	tuizhu
搬著	banzhu
协力	xieli
送往	songwang
群体	qunti
不胜	busheng
深仇	shenchou
不记	buji
记仇	jichou
君子	junzi
所贴	suotie
增广见闻	zengguangjianwen
病魔	bingmo
匮乏	guifa
身亡	shenwang
支撑	zhicheng
没嫌	meixian
抱到	baodao
修女	xiunv
撞见	zhuangjian
急救	jijiu
偏移	pianyi
凌虐	lingnue
兽医	shouyi
警告	jinggao
原始	yuanshi
徘回	paihui
谏言	jianyan
红字	hongzi
白纸	baizhi
鹦鹉	yingwu
附和	fuhe
模仿	mofang
教学相长	jiaoxuexiangchang
带球	daiqiu
踢进	tijin
冲到	chongdao
阻止	zuzhi
要看	yaokan
等来	denglai
一分耕耘	yifengengyun
地耕云	digengyun
更替	gengti
受惠	shouhui
报答	baoda
升上去	shengshangqu
职员	zhiyuan
赞同	zantong
仪态	yitai
书本上	shubenshang
黑炭	heitan
脑细胞	naoxibao
拚命	panming
投机取巧	toujiquqiao
斗志	douzhi
地步	dibu
紧张感	jinzhanggan
速食店	sushidian
消除	xiaochu
获胜	huosheng
竞争力	jingzhengli
失败者	shibaizhe
胜利者	shenglizhe
白费力气	baifeiliqi
装备	zhuangbei
有助于	youzhuyu
毒奶	dunai
高分	gaofen
佳绩	jiaji
创下	chuangxia
动机	dongji
风光	fengguang
数学老师	shuxuelaoshi
钢琴家	gangqinjia
初入	churu
看齐	kanqi
下定	xiading
听从	tingcong
写文章	xiewenzhang
徬徨	panghuang
所选	suoxuan
活好	huohao
显现出	xianxianchu
琴艺	qinyi
团里	tuanli
弦乐	xianle
深入	shenru
神灯	shendeng
骗术	pianshu
市集	shiji
精灵	jingling
烧光	shaoguang
逃出来	taochulai
睫毛	jiemao
眉毛	meimao
能克服	nengkefu
起起伏伏	qiqifufu
真面目	zhenmianmu
方型	fangxing
一筒	yitong
能通容	nengtongrong
睡觉时	shuijueshi
编织成	bianzhicheng
挚爱	zhiai
伫立	zhuli
墙角	qiangjiao
震撼	zhenhan
脑袋	naodai
风纪	fengji
换来	huanlai
使命	shiming
滋长	zichang
奔跑	benpao
独钟	duzhong
水渍	shuizi
铁架	tiejia
生锈	shengxiu
内层	neiceng
银白色	yinbaise
外层	waiceng
中餐	zhongcan
累垮	leikua
死光	siguang
乱窜	luancuan
使者	shizhe
艳装	yanzhuang
四体	siti
走入	zouru
馨香	xinxiang
在用	zaiyong
零分	lingfen
撕破	sipo
挖出	wachu
班长	banchang
小角色	xiaojiaose
痴想	chixiang
夫妻	fuqi
投篮	toulan
大吵一架	dachaoyijia
著球	zhuqiu
媒介	meijie
摆荡	baidang
指著	zhizhu
冲出	chongchu
上多	shangduo
白字	baizi
洗净	xijing
前线	qianxian
地近	dijin
跟不上	genbushang
吐出	tuchu
心思	xinsi
蹦蹦跳跳	bengbengtiaotiao
黑字	heizi
大脑	danao
容量	rongliang
牢记	laoji
期盼	qipan
雀跃不已	queyuebuyi
合力	heli
获取	huoqu
断金	duanjin
感触	ganchu
小部份	xiaobufen
缘份	yuanfen
巧合	qiaohe
学测	xuece
能不能够	nengbunenggou
铺陈	puchen
成器	chengqi
转弯	zhuanwan
洗脑	xinao
民主	minzhu
成语	chengyu
两条路	liangtiaolu
进定	jinding
旅途	lvtu
专科毕业	zhuankebiye
家计	jiaji
功地	gongdi
切记	qieji
航向	hangxiang
导引	daoyin
助力	zhuli
化为	huawei
环境影响	huanjingyingxiang
述说	shushuo
建言	jianyan
驱动器	qudongqi
发扬	fayang
三思	sansi
探寻	tanxun
起点	qidian
开展	kaizhan
锁住	suozhu
形态	xingtai
所订	suoding
不止	buzhi
彩券	caiquan
用取	yongqu
伟大成就	weidachengjiu
迈开	maikai
捉准	zhuozhun
不出	buchu
好学	haoxue
预习	yuxi
发问	fawen
阻力	zuli
飘过	piaoguo
苍穹	cangqiong
艺术界	yishujie
有权	youquan
开放	kaifang
拉伤	lashang
肌肉	jirou
水彩	shuicai
素描	sumiao
逼近	bijin
踏出	tachu
辨识	bianshi
发芽	faya
种子	zhongzi
弹场	danchang
阴错阳差	yincuoyangcha
地报	dibao
漆弹	qidan
厮杀	sisha
会离	huili
播放	bofang
认真学习	renzhenxuexi
妈教	majiao
要替	yaoti
静坐	jingzuo
演奏	yanzou
拉奏	lazou
提琴家	tiqinjia
弦律	xianlv
结晶	jiejing
善变	shanbian
难事	nanshi
感叹	gantan
恒河沙数	hengheshashu
印记	yinji
耻笑	chixiao
小巷	xiaoxiang
计划表	jihuabiao
难关	nanguan
出卖	chumai
节能	jieneng
掉落	diaoluo
飘落	piaoluo
落叶	luoye
老树	laoshu
脱掉	tuodiao
来临	lailin
毕业典礼	biyedianli
忧伤	youshang
贪玩	tanwan
吹著	chuizhu
旅人	lvren
堂兄弟	tangxiongdi
惦记	dianji
寒风	hanfeng
示威	shiwei
变色	bianse
离情	liqing
感伤	ganshang
玩伴	wanban
讲谈	jiangtan
和球	heqiu
堆积	duiji
打著	dazhu
操场上	caochangshang
社团	shetuan
摆动	baidong
节奏	jiezou
贪心	tanxin
不求	buqiu
足足	zuzu
事俗	shisu
脱离	tuoli
虫鸣	chongming
鸟叫	niaojiao
聆听	lingting
用钱	yongqian
散发出	sanfachu
气息	qixi
抱抱	baobao
著用	zhuyong
字条	zitiao
角度看	jiaodukan
排斥	paichi
昂头	angtou
展翅	zhanchi
蜜蜂	mifeng
高歌	gaoge
开采	kaicai
处于	chuyu
医治	yizhi
打玩	dawan
发生争执	fashengzhengzhi
纷争	fenzheng
天地	tiandi
看不完	kanbuwan
去逛	quguang
肚子痛	duzitong
趣味	quwei
得手	deshou
挥汗	huihan
心绘	xinhui
书香	shuxiang
死党	sidang
增添	zengtian
没效	meixiao
搞坏	gaohuai
援手	yuanshou
伸出	shenchu
秘方	mifang
户外活动	huwaihuodong
四肢	sizhi
时节	shijie
画是	huashi
口头禅	koutoushan
地站	dizhan
畏畏缩缩	weiweisuosuo
解决不了	jiejuebule
花儿	huaer
出动	chudong
云门舞集	yunmenwuji
舞姿	wuzi
扭动	niudong
书法	shufa
不舍	bushe
负责人	fuzeren
保有	baoyou
捕捉	buzhuo
摧折	cuizhe
死寂	siji
花草	huacao
修饰	xiushi
雕琢	diaozhuo
刀子	daozi
主因	zhuyin
飘散	piaosan
带向	daixiang
树儿	shuer
肆虐	sinue
失火	shihuo
爬出来	pachulai
刻著	kezhu
负荷	fuhe
吱吱声	zhizhisheng
物柜	wugui
组长	zuchang
引来	yinlai
滋润	zirun
戏码	xima
上演	shangyan
品德	pinde
居所	jusuo
念著	nianzhu
报时	baoshi
经文	jingwen
隐居	yinju
消磨	xiaomo
顽童	wantong
好似	haosi
转动	zhuandong
趣事	qushi
上好	shanghao
画纸	huazhi
充斥	chongchi
虐待	nuedai
回过	huiguo
接下	jiexia
展望	zhanwang
惨叫声	canjiaosheng
套句	taoju
柔中带刚	rouzhongdaigang
座号	zuohao
想像力	xiangxiangli
园地	yuandi
停电	tingdian
一题	yiti
前门	qianmen
有数	youshu
进人	jinren
裂开	liekai
大纸	dazhi
细心地	xixindi
能出	nengchu
用得	yongde
最让人	zuirangren
桌垫	zhuodian
任课老师	renkelaoshi
污渍	wuzi
去除	quchu
出息	chuxi
裁决	caijue
裂掉	liediao
塑胶	sujiao
餐桌	canzhuo
用途	yongtu
过漆	guoqi
罚刷	fashua
口臭	kouchou
使用者	shiyongzhe
孤立	guli
热血	rexie
男子	nanzi
发出	fachu
难求	nanqiu
忘却	wangque
时猪	shizhu
杀猪	shazhu
指甲	zhijia
叫声	jiaosheng
自闭症	zibizheng
转过身	zhuanguoshen
慰问	weiwen
见证	jianzheng
取出	quchu
否认	fouren
可无	kewu
倒胃口	daoweikou
见著	jianzhu
杰作	jiezuo
精心	jingxin
榆荫	yuyin
表格	biaoge
注视	zhushi
风味	fengwei
课桌	kezhuo
切割	qiege
半死	bansi
大伙	dahuo
地想	dixiang
环上	huanshang
能学	nengxue
课本上	kebenshang
比待	bidai
诉苦	suku
能带	nengdai
拆下来	chaixialai
午饭时间	wufanshijian
美事	meishi
正值	zhengzhi
不受	bushou
情谊	qingyi
视线	shixian
镜片	jingpian
增厚	zenghou
鬼屋	guiwu
做坏	zuohuai
校庆	xiaoqing
笔落	biluo
全责	quanze
钥匙孔	yaochikong
松脱	songtuo
看得出	kandechu
怜悯	lianmin
浸湿	jinshi
端详	duanxiang
待遇	daiyu
杂物	zawu
空荡	kongdang
了爱	leai
校园生活	xiaoyuanshenghuo
师生关系	shishengguanxi
架子	jiazi
火箭	huojian
宣布	xuanbu
聚集	juji
油性	youxing
学生上课	xueshengshangke
弟妹们	dimeimen
起立	qili
写下	xiexia
小生	xiaosheng
救人	jiuren
海流	hailiu
海水	haishui
所朝	suozhao
愠怒	yunnu
刺入	ciru
飘荡	piaodang
盘算	pansuan
补好	buhao
热忱	rechen
可敌	kedi
熄灭	ximie
学科知识	xuekezhishi
团队	tuandui
抄小路	chaoxiaolu
禁药	jinyao
假球	jiaqiu
寻觅	xunmi
勤学	qinxue
抽像	chouxiang
词字	cizi
步入	buru
主张	zhuzhang
害到	haidao
慎选	shenxuan
贯彻	guanche
找上门	zhaoshangmen
动弹	dongdan
口吻	kouwen
请求	qingqiu
加分	jiafen
负向	fuxiang
办不到	banbudao
厨艺	chuyi
宵夜	xiaoye
选烤	xuankao
香肠	xiangchang
事会	shihui
坏主意	huaizhuyi
保障	baozhang
头会	touhui
碰面	pengmian
夹克	jiake
淡蓝色	danlanse
日本料理	ribenliaoli
市林	shilin
完泳	wanyong
短裤	duanku
认出来	renchulai
见面会	jianmianhui
不敢想像	buganxiangxiang
桃红色	taohongse
青绿色	qinglvse
皮包	pibao
文具用品	wenjuyongpin
几层楼	jicenglou
卖书	maishu
确信	quexin
来往	laiwang
特点	tedian
关门	guanmen
先见	xianjian
凉鞋	liangxie
袖子	xiuzi
好长	haochang
凉面	liangmian
糖醋鱼	tangcuyu
烤鸡	kaoji
菜色	caise
纪念馆	jinianguan
影城	yingcheng
信义路	xinyilu
市景	shijing
顶楼	dinglou
吃完	chiwan
小店	xiaodian
分量	fenliang
尾巴	weiba
妳是	naishi
笔友	biyou
睡著	shuizhu
咖里	kali
提早	tizao
恤和	xuhe
身高	shengao
写封信	xiefengxin
预订	yuding
淡黄色	danhuangse
裙子	qunzi
咖啡店	kafeidian
烧肉	shaorou
自助	zizhu
可去	kequ
乐园	leyuan
窝心	woxin
真让人	zhenrangren
亲身	qinshen
留意	liuyi
搬去	banqu
相认	xiangren
谈得来	tandelai
熬过	aoguo
好找	haozhao
好孩子	haohaizi
甜点	tiandian
饼干	binggan
将法	jiangfa
太有钱	taiyouqian
一束花	yishuhua
了上	leshang
乱跑	luanpao
记掉	jidiao
规矩	guiju
来师	laishi
上排	shangpai
服药	fuyao
反抗	fankang
不在	buzai
姨妈	yima
贵人	guiren
零用钱	lingyongqian
水果	shuiguo
姨妈家	yimajia
打麻将	damajiang
恢复健康	huifujiankang
没给	meigei
大哭	daku
哭成	kucheng
可为	kewei
痴呆症	chidaizheng
先教	xianjiao
出锋头	chufengtou
选美	xuanmei
自爱	ziai
姓张	xingzhang
特别强调	tebieqiangdiao
输血	shuxie
过份	guofen
休闲服	xiuxianfu
认不出来	renbuchulai
电动玩具	diandongwanju
画品	huapin
新竹人	xinzhuren
传信	chuanxin
熟人	shuren
大减价	dajianjia
逛到	guangdao
脚酸	jiaosuan
点心店	dianxindian
吃饱	chibao
黑糖	heitang
爵士音乐	jueshiyinle
春水	chunshui
信义	xinyi
王家	wangjia
忍不住	renbuzhu
发脾气	fapiqi
晚起	wanqi
好喝	haohe
试一试	shiyishi
别忘记	biewangji
如意	ruyi
烤鸡肉	kaojirou
牛排	niupai
西式	xishi
紫色	zise
红线	hongxian
下车	xiache
法国电影	faguodianying
玫瑰花	meiguihua
花节	huajie
花开	huakai
樱花	yinghua
查到	chadao
买值	maizhi
飞镖	feibiao
旗山	qishan
想约	xiangyue
国画	guohua
艺术作品	yishuzuopin
洋装	yangzhuang
下午茶	xiawucha
商场	shangchang
购买	goumai
泡茶	paocha
忍者	renzhe
半价	banjia
红包	hongbao
大衣	dayi
师范大学	shifandaxue
大门	damen
樱桃花	yingtaohua
花地	huadi
赏花	shanghua
下雪	xiaxue
鞭炮	bianpao
全景	quanjing
留长	liuchang
毛衣	maoyi
高地	gaodi
再配	zaipei
娃娃	wawa
红衣服	hongyifu
几本书	jibenshu
猫熊	maoxiong
团团圆圆	tuantuanyuanyuan
门票	menpiao
坐车	zuoche
做做	zuozuo
随性	suixing
联考	liankao
妈生	masheng
得住	dezhu
过地	guodi
接住	jiezhu
说不完	shuobuwan
搬到	bandao
出差	chucha
秘书	mishu
请客	qingke
真棒	zhenbang
姑娘	guniang
法国菜	faguocai
合性	hexing
得靠	dekao
文论	wenlun
赠送	zengsong
脱身	tuoshen
帮著	bangzhu
变多	bianduo
同感	tonggan
社会学	shehuixue
在读	zaidu
双胞胎	shuangbaotai
来家	laijia
累死	leisi
考进	kaojin
试看	shikan
公立	gongli
专柜	zhuangui
总公司	zonggongsi
考到	kaodao
宾士	binshi
买下来	maixialai
看中	kanzhong
浪费资源	langfeiziyuan
保护环境	baohuhuanjing
爱著	aizhu
承诺	chengnuo
人妖	renyao
首歌	shouge
合唱	hechang
圣诞老人	shengdanlaoren
疑似	yisi
演讲比赛	yanjiangbisai
同学会	tongxuehui
敌国	diguo
气死	qisi
歌是	geshi
学法	xuefa
休闲	xiuxian
准备会	zhunbeihui
打哈欠	dahaqian
录音带	luyindai
代为	daiwei
团想	tuanxiang
月饼	yuebing
单字	danzi
会长	huichang
想请	xiangqing
帮该	banggai
喜剧	xiju
剧场	juchang
演员	yanyuan
信相	xinxiang
扯铃	cheling
帮到	bangdao
玩法	wanfa
拉扯	lache
运动场	yundongchang
民谣	minyao
听不出来	tingbuchulai
收音机	shouyinji
歌谱	gepu
看不出来	kanbuchulai
找买	zhaomai
买换	maihuan
要换	yaohuan
坏掉	huaidiao
常买	changmai
硬碟	yingdie
笔电	bidian
连开	liankai
逛著	guangzhu
司长	sichang
耳环	erhuan
刻下来	kexialai
圆盘	yuanpan
检视	jianshi
动静	dongjing
蜜粉	mifen
口红	kouhong
轮到	lundao
皮带	pidai
菜单	caidan
特餐	tecan
完让	wanrang
没买	meimai
物价	wujia
纪念品	jinianpin
筷子	kuaizi
峡谷	xiagu
二手车	ershouche
汇率	huilv
跌下	diexia
买车	maiche
市中心	shizhongxin
说起	shuoqi
发红	fahong
流汗	liuhan
人动	rendong
太小	taixiao
发薪水	faxinshui
挤满	jiman
板桥	banqiao
试穿	shichuan
使留	shiliu
本店	bendian
没贴	meitie
帐单	zhangdan
还加	huanjia
防晒	fangshai
运到	yundao
发火	fahuo
卖肉	mairou
第二课	dierke
第三课	disanke
水平	shuiping
时间差	shijiancha
小家	xiaojia
得买	demai
北京烤鸭	beijingkaoya
儿话	erhua
航空公司	hangkonggongsi
铁蛋	tiedan
红楼	honglou
弹跳	dantiao
高空	gaokong
扑克牌	pukepai
没起	meiqi
亲戚朋友	qinqipengyou
满身	manshen
不卖	bumai
打坐	dazuo
出家人	chujiaren
散布	sanbu
可并	kebing
镇压	zhenya
玩水	wanshui
后坐	houzuo
录取	luqu
要住	yaozhu
清水	qingshui
想骗	xiangpian
司机	siji
签证	qianzheng
尖峰	jianfeng
车辆	cheliang
太丑	taichou
问店	wendian
换换	huanhuan
出租汽车	chuzuqiche
宾馆	binguan
预定	yuding
开满	kaiman
步道	budao
搭错	dacuo
聊得	liaode
法国人	faguoren
描述	miaoshu
不太能	butaineng
双人	shuangren
满多	manduo
企鹅	qie
电车	dianche
电车站	dianchezhan
歌星	gexing
水饺	shuijiao
飞票	feipiao
难选	nanxuan
再选	zaixuan
存钱	cunqian
不花	buhua
礼堂	litang
文件	wenjian
中午饭	zhongwufan
农场	nongchang
都菜	ducai
尝一尝	changyichang
小菜	xiaocai
有够	yougou
海豚	haitun
拍照	paizhao
下学	xiaxue
进不去	jinbuqu
瓶酒	pingjiu
碗筷	wankuai
美式	meishi
高位	gaowei
涨值	zhangzhi
烟火	yanhuo
要命	yaoming
大会	dahui
名胜古迹	mingshengguji
电动车	diandongche
灯台	dengtai
人盖	rengai
再建	zaijian
转班	zhuanban
班机	banji
手续	shouxu
办理	banli
客运	keyun
穷学生	qiongxuesheng
遇上	yushang
咖非	kafei
地土	ditu
花戴	huadai
脖子	bozi
脱下来	tuoxialai
学分	xuefen
跟坐	genzuo
跟我学	genwoxue
语跟	yugen
没教	meijiao
数学系	shuxuexi
学完	xuewan
错事	cuoshi
心得	xinde
想学	xiangxue
化学	huaxue
飞弹	feidan
决解	juejie
暑期班	shuqiban
现代文学	xiandaiwenxue
先读	xiandu
温习	wenxi
学英	xueying
教育系	jiaoyuxi
缺课	queke
笔记本	bijiben
口语	kouyu
挑战性	tiaozhanxing
书面	shumian
生物课	shengwuke
记字	jizi
准时	zhunshi
学为	xuewei
路道	ludao
煞车	shache
夺魁	duokui
省油	shengyou
冠军	guanjun
驾驶	jiashi
心站	xinzhan
观想	guanxiang
写实	xieshi
踪影	zongying
反射	fanshe
教是	jiaoshi
研究成果	yanjiuchengguo
读力	duli
当地人	dangdiren
桑额	sange
扣分	koufen
西班牙话	xibanyahua
策是	ceshi
开眼界	kaiyanjie
商人	shangren
假话	jiahua
卖坏	maihuai
证书	zhengshu
课会	kehui
比方	bifang
历史背景	lishibeijing
哲学	zhexue
内战	neizhan
得教	dejiao
背书	beishu
考试分数	kaoshifenshu
课外活动	kewaihuodong
年青人	nianqingren
念错	niancuo
看新	kanxin
历史课	lishike
政治经济	zhengzhijingji
校外活动	xiaowaihuodong
帮有	bangyou
神经病	shenjingbing
队员	duiyuan
先寄	xianji
欧洲人	ouzhouren
合得来	hedelai
开会	kaihui
离别	libie
信用卡	xinyongqia
搭讪	dashan
知心朋友	zhixinpengyou
样貌	yangmao
灰色	huise
不高不矮	bugaobuai
牙齿	yachi
苗条	miaotiao
认一	renyi
可明	keming
上交	shangjiao
恐怖电影	kongbudianying
型式	xingshi
不害羞	buhaixiu
林家	linjia
锻炼身体	duanlianshenti
愿不愿意	yuanbuyuanyi
白花	baihua
科学课	kexueke
期末考试	qimokaoshi
生物学	shengwuxue
大跌	dadie
帮帮我	bangbangwo
指出	zhichu
冲浪板	chonglangban
有意	youyi
住著	zhuzhu
点儿	dianer
狮子	shizi
坐跑	zuopao
月经	yuejing
跑不掉	paobudiao
切掉	qiediao
飞快	feikuai
成真	chengzhen
旁边儿	pangbianer
家离	jiali
地铁站	ditiezhan
悠游	youyou
大象	daxiang
猴子	houzi
跳下来	tiaoxialai
血流	xieliu
温度	wendu
转过	zhuanguo
蒸鱼	zhengyu
酱油	jiangyou
梦国	mengguo
惊吓	jingxia
小黑点	xiaoheidian
深红色	shenhongse
察觉	chajue
上床睡觉	shangchuangshuijue
黑夜	heiye
投票	toupiao
兔子	tuzi
找麻烦	zhaomafan
杀掉	shadiao
报仇	baochou
红萝卜	hongluobu
想不出	xiangbuchu
飞著	feizhu
吵得	chaode
所辟	suopi
上锁	shangsuo
借来	jielai
邀请卡	yaoqingqia
大使	dashi
制服	zhifu
夜会	yehui
短剧	duanju
所需	suoxu
烦请	fanqing
对白	duibai
节奏感	jiezougan
模范	mofan
共用	gongyong
外籍	waiji
天才	tiancai
教材	jiaocai
敬请	jingqing
硬体	yingti
软体	ruanti
讲演	jiangyan
美术	meishu
晚会节目	wanhuijiemu
改写	gaixie
独唱	duchang
录音机	luyinji
音响	yinxiang
会合	huihe
晒黑	shaihei
奖金	jiangjin
改改	gaigai
复印	fuyin
返信	fanxin
导演	daoyan
帮不了	bangbule
大使馆	dashiguan
奖品	jiangpin
表更	biaogeng
挫折感	cuozhegan
京剧	jingju
烘焙	hongbei
电子辞典	dianzicidian
带回家	daihuijia
找卖	zhaomai
报警	baojing
买长	maichang
集收	jishou
质讯	zhixun
电脑店	diannaodian
看选	kanxuan
笔记型电脑	bijixingdiannao
笔记型	bijixing
地算	disuan
算省	suansheng
鞋店	xiedian
价格比	jiagebi
皮鞋	pixie
脚痛	jiaotong
大够	dagou
符合	fuhe
台股	taigu
飙到	biaodao
大盘	dapan
指数	zhishu
股票	gupiao
户头	hutou
开户	kaihu
证券公司	zhengquangongsi
下单	xiadan
买价	maijia
凝视	ningshi
股东	gudong
口袋	koudai
动表	dongbiao
中国画	zhongguohua
新鲜感	xinxiangan
老板娘	laobanniang
视听	shiting
笔者	bizhe
品牌	pinpai
要生	yaosheng
底片	dipian
便宜货	bianyihuo
周到	zhoudao
食饮	shiyin
进水	jinshui
退换	tuihuan
一块钱	yikuaiqian
要买	yaomai
一分货	yifenhuo
一分钱	yifenqian
收据	shouju
盒子	hezi
鸽子	gezi
骑著	qizhu
撩乱	liaoluan
鸟类	niaolei
体型	tixing
鸟会	niaohui
补款	bukuan
碎念	suinian
买花	maihua
花市	huashi
花束	huashu
室内空间	shineikongjian
热带气候	redaiqihou
玉市	yushi
黄金	huangjin
水水	shuishui
葡萄	putao
每颗	meike
电器店	dianqidian
无线网	wuxianwang
接续	jiexu
喝牛奶	heniunai
豆浆	doujiang
杯子	beizi
满足感	manzugan
地厚	dihou
新鞋	xinxie
穿上	chuanshang
讲价	jiangjia
还价	huanjia
电子产品	dianzichanpin
降价	jiangjia
铭传	mingchuan
基河	jihe
校区	xiaoqu
过手	guoshou
手环	shouhuan
试一下	shiyixia
服务中心	fuwuzhongxin
跟位	genwei
拿给	nagei
摆在	baizai
想看	xiangkan
搭往	dawang
盛情	shengqing
贴身	tieshen
著团	zhutuan
露营	luying
身入	shenru
俯瞰	fukan
圆圆	yuanyuan
团团	tuantuan
团圆	tuanyuan
分放	fenfang
福音	fuyin
教学方法	jiaoxuefangfa
刚学	gangxue
短片	duanpian
包含	baohan
因由	yinyou
习俗	xisu
文化背景	wenhuabeijing
当掉	dangdiao
难堪	nankan
指正	zhizheng
词学	cixue
后学	houxue
减小	jianxiao
出版	chuban
句型	juxing
混淆	hunyao
恶意	eyi
轮流	lunliu
抱歉	baoqian
字汇	zihui
上慢	shangman
义字	yizi
造句	zaoju
相近	xiangjin
加修	jiaxiu
加更	jiageng
著死	zhusi
学错	xuecuo
迷惑	mihuo
只用	zhiyong
所教	suojiao
四川菜	sichuancai
蛇肉	sherou
辣味	lawei
菜差	caicha
猪肉	zhurou
鱼香茄子	yuxiangqiezi
吃水	chishui
苹果派	pingguopai
热狗	regou
义式	yishi
芝麻油	zhimayou
橄榄油	ganlanyou
面条	miantiao
鸡脚	jijiao
尝过	changguo
馒头	mantou
有油	youyou
视觉	shijue
太油	taiyou
住舍	zhushe
自愿地	ziyuandi
菜加肉	caijiarou
连肉	lianrou
豆瓣酱	doubanjiang
洋葱	yangcong
番茄	fanqie
吃著	chizhu
普洱茶	puercha
芋圆	yuyuan
烤鸭	kaoya
热菜	recai
用油	yongyou
用水	yongshui
相比	xiangbi
木瓜	mugua
港式	gangshi
蜜汁	mizhi
肉片	roupian
火腿	huotui
窃喜	qiexi
涵义	hanyi
引擎	yinqing
打领带	dalingdai
身分	shenfen
风格	fengge
前辈	qianbei
空白	kongbai
名列	minglie
名誉	mingyu
质疑	zhiyi
普通人	putongren
贵族	guizu
办葬事	banzangshi
起有	qiyou
茶叶	chaye
意想	yixiang
物事	wushi
买来	mailai
坐电梯	zuodianti
忘带	wangdai
动手	dongshou
油条	youtiao
集和	jihe
建物	jianwu
地念	dinian
经典	jingdian
穿厚	chuanhou
冷有	lengyou
泡面	paomian
圆领衫	yuanlingshan
明洞	mingdong
联宜	lianyi
银座	yinzuo
文采	wencai
名片	mingpian
支付	zhifu
寄钱	jiqian
侄子	zhizi
经理	jingli
事分	shifen
聊聊	liaoliao
留住	liuzhu
住宅区	zhuzhaiqu
便利商店	bianlishangdian
日用品	riyongpin
只得	zhide
养著	yangzhu
待著	daizhu
买离	maili
学系	xuexi
交通费	jiaotongfei
脱水机	tuoshuiji
食堂	shitang
亲戚	qinqi
装电	zhuangdian
分平	fenping
分表	fenbiao
租出去	zuchuqu
土地	tudi
卫生设备	weishengshebei
省事	shengshi
教堂	jiaotang
炒年糕	chaoniangao
顾著	guzhu
让步	rangbu
先入	xianru
丢掉	diudiao
扇子	shanzi
想越	xiangyue
性别	xingbie
口气	kouqi
没进	meijin
终止	zhongzhi
姑母	gumu
受苦	shouku
没上	meishang
爬上去	pashangqu
足球场	zuqiuchang
看台	kantai
水源	shuiyuan
得分	defen
踢球	tiqiu
下半场	xiabanchang
餐店	candian
独吞	dutun
尽孝	jinxiao
水电	shuidian
样式	yangshi
电器	dianqi
表妹	biaomei
跨过	kuaguo
住区	zhuqu
无车	wuche
买有	maiyou
代步	daibu
晚一点	wanyidian
下雨天	xiayutian
漏水	loushui
了算	lesuan
住惯	zhuguan
养花	yanghua
水箱	shuixiang
银色	yinse
正桥	zhengqiao
单人房	danrenfang
合租	hezu
房价	fangjia
采光	caiguang
一楼	yilou
疯子	fengzi
可好	kehao
邻近	linjin
值钱	zhiqian
迁去	qianqu
电楼	dianlou
租房	zufang
卖场	maichang
开伙	kaihuo
输于	shuyu
雪衣	xueyi
气温	qiwen
娘家	niangjia
值去	zhiqu
值看	zhikan
豆花	douhua
泡泡	paopao
能尝	nengchang
天母	tianmu
家住	jiazhu
游泳衣	youyongyi
要装	yaozhuang
校花	xiaohua
责任感	zerengan
苦日子	kurizi
真令	zhenling
红衫	hongshan
人潮	renchao
带动	daidong
塞著	saizhu
马桶	matong
政治犯	zhengzhifan
臭气	chouqi
逼人	biren
表出	biaochu
效力	xiaoli
之术	zhishu
用场	yongchang
无用	wuyong
哲学家	zhexuejia
学子	xuezi
学位	xuewei
想得开	xiangdekai
日久生情	rijiushengqing
有恩	youen
人德	rende
教到	jiaodao
生字	shengzi
青任	qingren
事务所	shiwusuo
体重	tizhong
老家	laojia
代班	daiban
传道	chuandao
举止	juzhi
坦途	tantu
聚精会神	jujinghuishen
中意	zhongyi
归功于	guigongyu
真理	zhenli
交际	jiaoji
应酬	yingchou
纪律	jilv
纪馆	jiguan
效角	xiaojiao
带重	daizhong
博物	bowu
了住	lezhu
买西	maixi
小点心	xiaodianxin
折合	zhehe
担仔面	danzimian
聊聊吧	liaoliaoba
想写	xiangxie
旅客	lvke
穗子	suizi
体力	tili
茶馆	chaguan
游乐园	youleyuan
宝物	baowu
适云	shiyun
叩上	koushang
感谢上帝	ganxieshangdi
汽运	qiyun
国光	guoguang
飞狗	feigou
气象报告	qixiangbaogao
炸鸡	zhaji
热度	redu
珍珠奶茶	zhenzhunaicha
卤味	luwei
种菜	zhongcai
带回去	daihuiqu
再聊	zailiao
是非	shifei
出家	chujia
再上	zaishang
华侨	huaqiao
受害者	shouhaizhe
谣言	yaoyan
国籍	guoji
吐血	tuxie
咳嗽	kesou
转好	zhuanhao
住院	zhuyuan
农历	nongli
哭著	kuzhu
古迹	guji
恐布	kongbu
恐怖份子	kongbufenzi
炸弹	zhadan
奉办	fengban
坐过	zuoguo
拉肚子	laduzi
肠炎	changyan
发烧	fashao
急性	jixing
宿室	sushi
仅存	jincun
圣灵	shengling
责怪	zeguai
偏见	pianjian
医换	yihuan
能治	nengzhi
中式	zhongshi
迷信	mixin
度到	dudao
捐钱	juanqian
老子	laozi
继承	jicheng
所想	suoxiang
黑人	heiren
白人	bairen
敌人	diren
大熊猫	daxiongmao
专家	zhuanjia
大熊	daxiong
蜘蛛	zhizhu
变有	bianyou
蜘蛛人	zhizhuren
反应速度	fanyingsudu
喷出	penchu
视力	shili
对决	duijue
隐瞒	yinman
后续	houxu
啤酒店	pijiudian
说来	shuolai
还求	huanqiu
功夫片	gongfupian
演假	yanjia
演得	yande
喝醉	hezui
打人	daren
演技	yanji
喜剧片	xijupian
爱情片	aiqingpian
谍对谍	dieduidie
黑手	heishou
指使	zhishi
背叛	beipan
装扮	zhuangban
变声	biansheng
变脸	bianlian
面具	mianju
剧团	jutuan
奉上	fengshang
影后	yinghou
歌声	gesheng
顶级	dingji
剧中	juzhong
情节	qingjie
影院	yingyuan
钢铁	gangtie
套装	taozhuang
移交	yijiao
动画	donghua
中国武术	zhongguowushu
决赛	juesai
学徒	xuetu
转给	zhuangei
传奇	chuanqi
外婆家	waipojia
上映	shangying
爆米花	baomihua
制度	zhidu
教学材料	jiaoxuecailiao
鲸鱼	jingyu
祭祖	jizu
传说	chuanshuo
知与	zhiyu
能干	nenggan
针毡	zhenzhan
看护	kanhu
宠爱	chongai
名是	mingshi
弄碎	nongsui
恐怖分子	kongbufenzi
春呐	chunne
音乐风格	yinlefengge
移到	yidao
疼爱	tengai
佛祖	fozu
茶田	chatian
怀抱	huaibao
科幻片	kehuanpian
时间机器	shijianjiqi
传送	chuansong
关注	guanzhu
一辆车	yiliangche
飞上去	feishangqu
飞出去	feichuqu
鬼片	guipian
取经	qujing
妖怪	yaoguai
优于	youyu
徒弟	tudi
犯色	fanse
猪八戒	zhubajie
展示	zhanshi
过死	guosi
手语	shouyu
小营	xiaoying
小营会	xiaoyinghui
傻傻	shasha
男子汉	nanzihan
可亲	keqin
机器人	jiqiren
辈子	beizi
疗养院	liaoyangyuan
人世间	renshijian
所学	suoxue
关爱	guanai
患有	huanyou
题材	ticai
院经	yuanjing
导用	daoyong
义气	yiqi
国境	guojing
农人	nongren
上爱	shangai
穿衣服	chuanyifu
电影吧	dianyingba
出牢	chulao
电影片	dianyingpian
放映	fangying
战士	zhanshi
猜猜	caicai
赤壁	chibi
偶像剧	ouxiangju
特地	tedi
猜得到	caidedao
林口	linkou
下蛋	xiadan
生于	shengyu
老幼	laoyou
国际交流	guojijiaoliu
名称	mingcheng
欢呼	huanhu
门校	menxiao
网球	wangqiu
大猩猩	daxingxing
合照	hezhao
作曲家	zuoqujia
自称	zicheng
卷发	juanfa
全场	quanchang
尖叫	jianjiao
进场	jinchang
守卫	shouwei
阻挡	zudang
请来	qinglai
讲完	jiangwan
抽到	choudao
事业成功	shiyechenggong
唱的歌	changdege
碰来	penglai
碰去	pengqu
要始	yaoshi
团人	tuanren
影音	yingyin
激扬	jiyang
棒球员	bangqiuyuan
婆婆妈妈	popomama
捐出	juanchu
真令人	zhenlingren
学闲	xuexian
经济系	jingjixi
大餐	dacan
著有	zhuyou
纪念活动	jinianhuodong
义卖会	yimaihui
收信	shouxin
运动会	yundonghui
请帖	qingtie
同心合力	tongxinheli
球长	qiuchang
风潮	fengchao
激起	jiqi
开幕典礼	kaimudianli
懂事	dongshi
创立	chuangli
点名	dianming
有加	youjia
要办	yaoban
座谈会	zuotanhui
开幕	kaimu
超棒	chaobang
正妹	zhengmei
性感	xinggan
叫个不停	jiaogebuting
刻意	keyi
听歌	tingge
歌赛	gesai
听众	tingzhong
胖女人	pangnvren
幽默感	youmogan
嘲讽	chaofeng
亲和力	qinheli
少见	shaojian
少有	shaoyou
羡幕	xianmu
演讲会	yanjianghui
来开	laikai
签名会	qianminghui
自亲	ziqin
从头	congtou
歌曲	gequ
友友	youyou
电影明星	dianyingmingxing
做著	zuozhu
晚安	wanan
短时间	duanshijian
生讲	shengjiang
紧跟	jingen
写日记	xieriji
时段	shiduan
留著	liuzhu
猜到	caidao
花博	huabo
抢走	qiangzou
强盗	qiangdao
收回	shouhui
没交	meijiao
先猜	xiancai
心念	xinnian
带回	daihui
队差	duicha
选吃	xuanchi
心上人	xinshangren
养女	yangnv
温柔体贴	wenroutitie
正如	zhengru
出外	chuwai
表店	biaodian
好帅	haoshuai
写歌	xiege
会弹	huidan
主唱	zhuchang
告白	gaobai
打来	dalai
月光	yueguang
在弹	zaidan
转头	zhuantou
学妹	xuemei
姓林	xinglin
非洲人	feizhouren
光子	guangzi
表姊	biaozi
故乡	guxiang
黄身	huangshen
外交	waijiao
过得	guode
看越	kanyue
笑脸	xiaolian
比赛场地	bisaichangdi
国文课	guowenke
天儿	tianer
桥梁	qiaoliang
好著	haozhu
情人节	qingrenjie
消失掉	xiaoshidiao
山叶	shanye
物理学	wulixue
踢足球	tizuqiu
辛亏	xinkui
古典音乐	gudianyinle
歌剧院	gejuyuan
会令	huiling
超忙	chaomang
问候	wenhou
静宜	jingyi
语系	yuxi
谈著	tanzhu
国人	guoren
吧台	batai
葡萄酒	putaojiu
了用	leyong
交了	jiaole
会儿	huier
喝喝	hehe
评论	pinglun
写者	xiezhe
汉人	hanren
几族	jizu
养及	yangji
食品	shipin
殖民地	zhimindi
统治	tongzhi
中药	zhongyao
阅读者	yueduzhe
穴道	xuedao
内脏	neizang
作拔	zuoba
黄帝内经	huangdineijing
推拿	tuina
先买	xianmai
地理杂志	dilizazhi
借书	jieshu
大道理	dadaoli
读者	duzhe
利益	liyi
一念	yinian
念一念	nianyinian
直念	zhinian
害上	haishang
服从	fucong
修会	xiuhui
相会	xianghui
样样	yangyang
自卑	zibei
文是	wenshi
每课	meike
真子	zhenzi
太郎	tailang
砍掉	kandiao
强奸	qiangjian
日军	rijun
主持人	zhuchiren
羊肉	yangrou
野狼	yelang
念到	niandao
人种	renzhong
歧视	qishi
拿走	nazou
造诣	zaoyi
红豆	hongdou
村长	cunchang
年糕	niangao
讲解	jiangjie
泰生	taisheng
必修课	bixiuke
四书	sishu
法儿	faer
应用	yingyong
少花	shaohua
可向	kexiang
迈出	maichu
看起	kanqi
升官	shengguan
品管	pinguan
品检	pinjian
作业员	zuoyeyuan
上任	shangren
制程	zhicheng
应对	yingdui
国际标准	guojibiaozhun
认证	renzheng
涵盖	hangai
取得	qude
海龟	haigui
渡边	dubian
出逛	chuguang
出事	chushi
帮帮	bangbang
行健	xingjian
书脏	shuzang
便当盒	biandanghe
跑掉	paodiao
盘子	panzi
睡饱	shuibao
业绩	yeji
家会	jiahui
乱放	luanfang
脏衣	zangyi
乱动	luandong
相住	xiangzhu
吵醒	chaoxing
想能	xiangneng
交情	jiaoqing
保值	baozhi
作息时间	zuoxishijian
新友	xinyou
妥协	tuoxie
减轻	jianqing
乱丢垃圾	luandiulaji
下回	xiahui
忘关	wangguan
讶异	yayi
卫生习惯	weishengxiguan
发酸	fasuan
衣物	yiwu
集中地	jizhongdi
融洽	rongqia
理念	linian
音效	yinxiao
见谅	jianliang
方舟	fangzhou
啤酒瓶	pijiuping
坏消息	huaixiaoxi
取消	quxiao
起飞	qifei
下下	xiaxia
分类广告	fenleiguanggao
风暴	fengbao
销路	xiaolu
低迷	dimi
保安人员	baoanrenyuan
爬下去	paxiaqu
流血	liuxie
战友	zhanyou
怜得	liande
贷款	daikuan
退学	tuixue
机车	jiche
办好	banhao
看作	kanzuo
借口	jiekou
远有	yuanyou
大牛	daniu
说道	shuodao
障碍者	zhangaizhe
仔细听	zixiting
骗过	pianguo
笔签	biqian
观感	guangan
支票	zhipiao
借钱	jieqian
投缘	touyuan
利利	lili
外籍人士	waijirenshi
亲属	qinshu
名叫	mingjiao
育幼院	yuyouyuan
日式	rishi
冲绳	chongsheng
搬出去	banchuqu
会犯	huifan
废话	feihua
茶店	chadian
名店	mingdian
造访	zaofang
景点	jingdian
助人	zhuren
感慨	gankai
雨衣	yuyi
豆腐	doufu
录音	luyin
装潢	zhuanghuang
风水	fengshui
人买屋	renmaiwu
得知	dezhi
买主	maizhu
同胞	tongbao
带路	dailu
切肉	qierou
轮胎	luntai
备胎	beitai
为难	weinan
问道	wendao
车箱	chexiang
铁棍	tiegun
太短	taiduan
邻负	linfu
延长	yanchang
搬走	banzou
冷气机	lengqiji
生活用品	shenghuoyongpin
制品	zhipin
停车位	tingchewei
十楼	shilou
爬楼梯	palouti
石油	shiyou
使住	shizhu
投资方	touzifang
金融业	jinrongye
附著	fuzhu
物件	wujian
铁泥	tieni
网路费	wanglufei
租给	zugei
大间	dajian
市区	shiqu
光纤	guangxian
月份	yuefen
导览	daolan
使到	shidao
生活节奏	shenghuojiezou
社区	shequ
往外面	wangwaimian
豪情	haoqing
往右边	wangyoubian
聚餐	jucan
饭厅	fanting
化妆室	huazhuangshi
顺路	shunlu
双床	shuangchuang
房型	fangxing
视野	shiye
美容室	meirongshi
二楼	erlou
卧室	woshi
爸带	badai
医好	yihao
不收	bushou
做生日	zuoshengri
生出	shengchu
画廊	hualang
收藏	shoucang
艺术品	yishupin
祈祷	qidao
从重	congzhong
酥油茶	suyoucha
干杯	ganbei
风俗	fengsu
集合	jihe
地瓜	digua
盖炉	gailu
开火	kaihuo
炉子	luzi
橡皮圈	xiangpiquan
弄脏	nongzang
学期结束	xueqijieshu
涵意	hanyi
迈入	mairu
超大	chaoda
烤牛肉	kaoniurou
来请	laiqing
板娘	banniang
家庭用品	jiatingyongpin
交钱	jiaoqian
小票	xiaopiao
儿童节	ertongjie
考大学	kaodaxue
眼眶	yankuang
掉泪	diaolei
新娘	xinniang
喜宴	xiyan
伴娘	banniang
躺著	tangzhu
起司	qisi
鼓舞	guwu
闲晃	xianhuang
没人接	meirenjie
工作岗位	gongzuogangwei
冲向	chongxiang
国度	guodu
没过	meiguo
迎娶	yingqu
新郎	xinlang
对得起	duideqi
枕头	zhentou
把头	batou
海物	haiwu
鲸鲨	jingsha
旅游团	lvyoutuan
兴致	xingzhi
成长率	chengchanglv
上涨	shangzhang
图表	tubiao
新生儿	xinshenger
显示	xianshi
增至	zengzhi
人口数量	renkoushuliang
降于	jiangyu
图示	tushi
渐变	jianbian
最低点	zuididian
刻板	keban
没落	meiluo
计图	jitu
上表	shangbiao
增长	zengchang
科技时代	kejishidai
农业	nongye
消长	xiaochang
家务	jiawu
著变	zhubian
弄著	nongzhu
人口总数	renkouzongshu
人口统计	renkoutongji
比例	bili
计数	jishu
不料	buliao
图表说明	tubiaoshuoming
降下	jiangxia
往上升	wangshangsheng
走下坡	zouxiapo
产龄妇	chanlingfu
日益	riyi
独生子女	dushengzinv
搞垮	gaokua
拉上来	lashanglai
想生	xiangsheng
工作效率	gongzuoxiaolv
开销	kaixiao
育有	yuyou
夫妻间	fuqijian
传承	chuancheng
基因	jiyin
变慢	bianman
晚婚	wanhun
丈夫	zhangfu
早婚	zaohun
老化	laohua
培养教育	peiyangjiaoyu
生活水准	shenghuoshuizhun
结婚的人	jiehunderen
就业率	jiuyelv
地养	diyang
产假	chanjia
补助金	buzhujin
社会福利	shehuifuli
租税	zushui
佣人	yongren
耕耘	gengyun
资本主义	zibenzhuyi
差距	chaju
讯息	xunxi
高龄	gaoling
谋生	mousheng
食粮	shiliang
知识者	zhishizhe
活到	huodao
人命	renming
辞掉	cidiao
赞助	zanzhu
会因	huiyin
打不完	dabuwan
人类学者	renleixuezhe
讲述	jiangshu
市县	shixian
生率	shenglv
重病	zhongbing
开明	kaiming
体制	tizhi
养不起	yangbuqi
年轻夫妇	nianqingfufu
保险费	baoxianfei
变高	biangao
税金	shuijin
税率	shuilv
延期	yanqi
逻辑	luoji
统计	tongji
组成	zucheng
雇用	guyong
人力	renli
纳税	nashui
操作	caozuo
人口老化	renkoulaohua
青年人	qingnianren
男主	nanzhu
客族	kezu
暖化	nuanhua
水资源	shuiziyuan
存量	cunliang
减缓	jianhuan
密度	midu
规范	guifan
论述	lunshu
缓冲带	huanchongdai
恢复元气	huifuyuanqi
产子	chanzi
智力	zhili
注册	zhuce
辩论	bianlun
没高	meigao
化太	huatai
现代文明	xiandaiwenming
暴增	baozeng
收割	shouge
播种	bozhong
可转	kezhuan
称道	chengdao
后遗症	houyizheng
拯救	zhengjiu
单亲	danqin
缓住	huanzhu
赏金	shangjin
已婚	yihun
孩儿	haier
诅咒	zuzhou
不生	busheng
要花费	yaohuafei
拆毁	chaihui
建造	jianzao
据统计	jutongji
发布	fabu
抵免	dimian
优惠政策	youhuizhengce
意味	yiwei
保守	baoshou
原料	yuanliao
杀手	shashou
够用	gouyong
出对	chudui
全力	quanli
平均寿命	pingjunshouming
攀升	pansheng
医药	yiyao
消耗	xiaohao
求知	qiuzhi
栋梁	dongliang
阶层	jieceng
引进	yinjin
迫使	poshi
利害关系	lihaiguanxi
提及	tiji
迫害	pohai
剥削	boxue
有无	youwu
移走	yizou
减以	jianyi
女主	nvzhu
化能	huaneng
助于	zhuyu
化是	huashi
造人	zaoren
观赏	guanshang
俗称	sucheng
不移	buyi
可喜可贺	kexikehe
地会	dihui
效益	xiaoyi
留守	liushou
女子	nvzi
兄姐	xiongjie
在外	zaiwai
少学	shaoxue
饿肚子	eduzi
欠缺	qianque
推动	tuidong
脑痛	naotong
乐于	leyu
成家立业	chengjialiye
延缓	yanhuan
高龄产妇	gaolingchanfu
得以	deyi
劳力	laoli
贴近	tiejin
育儿	yuer
正视	zhengshi
创照力	chuangzhaoli
厚非	houfei
香火	xianghuo
文盲	wenmang
老年人	laonianren
退化	tuihua
措施	cuoshi
缴清	jiaoqing
消费率	xiaofeilv
毕业生	biyesheng
产业	chanye
耗量	haoliang
观看	guankan
瞪目	dengmu
耗费	haofei
所花	suohua
只生	zhisheng
标语	biaoyu
化解	huajie
本性	benxing
疼惜	tengxi
有志者	youzhizhe
心肝宝贝	xinganbaobei
原状	yuanzhuang
专案	zhuanan
额度	edu
婚生子	hunshengzi
滚进	gunjin
渐进式	jianjinshi
巨轮	julun
经济负担	jingjifudan
一胎化	yitaihua
无从	wucong
倒闭	daobi
任教	renjiao
细胞	xibao
组织	zuzhi
创造性	chuangzaoxing
年长者	nianchangzhe
倒三角形	daosanjiaoxing
三角形	sanjiaoxing
失业率	shiyelv
略过	lveguo
经济社会	jingjishehui
离谱	lipu
计算	jisuan
化将	huajiang
生产率	shengchanlv
支出	zhichu
商业活动	shangyehuodong
税收	shuishou
公立学校	gonglixuexiao
私立学校	silixuexiao
退休年龄	tuixiunianling
少于	shaoyu
下列	xialie
服务业	fuwuye
人力资源	renliziyuan
结果显示	jieguoxianshi
招募	zhaomu
联合	lianhe
新人	xinren
跨国企业	kuaguoqiye
分公司	fengongsi
新进人员	xinjinrenyuan
创新能力	chuangxinnengli
广告业	guanggaoye
消费者	xiaofeizhe
适不	shibu
外观	waiguan
合不来	hebulai
创造物	chuangzaowu
野心	yexin
分工合作	fengonghezuo
胜过	shengguo
颠覆	dianfu
深入研究	shenruyanjiu
访问	fangwen
相当于	xiangdangyu
人养	renyang
搅扰	jiaorao
成问题	chengwenti
流浪	liulang
专业人士	zhuanyerenshi
方案	fangan
问林	wenlin
数学课	shuxueke
电影票	dianyingpiao
著写	zhuxie
吃药	chiyao
著去	zhuqu
文德	wende
睡衣	shuiyi
男孩子	nanhaizi
坐不住	zuobuzhu
秘秘	mimi
不下	buxia
公式	gongshi
跟我来	genwolai
老外	laowai
选不对	xuanbudui
问用	wenyong
托车	tuoche
台北人	taibeiren
摩模	momo
明说	mingshuo
认到	rendao
应为	yingwei
雨鞋	yuxie
面包店	mianbaodian
公高	gonggao
请买	qingmai
看车	kanche
停车	tingche
把手	bashou
开开	kaikai
放上	fangshang
总站	zongzhan
太湿	taishi
别致	biezhi
作饭	zuofan
菜盘盘	caipanpan
留信	liuxin
可聊	keliao
背著	beizhu
地问	diwen
买件	maijian
请留	qingliu
了请	leqing
了变	lebian
中正机场	zhongzhengjichang
选来	xuanlai
学字	xuezi
弥撒	misa
血缘	xieyuan
起不来	qibulai
懂吗	dongma
换上	huanshang
过头	guotou
晚点	wandian
好险	haoxian
乱讲	luanjiang
停车站	tingchezhan
开跑	kaipao
婆婆	popo
了坐	lezuo
觉醒	juexing
上身	shangshen
变快	biankuai
热水	reshui
喝水	heshui
急诊部	jizhenbu
礼遇	liyu
得考	dekao
早生贵子	zaoshengguizi
邀亲	yaoqin
探亲	tanqin
走不开	zoubukai
人带	rendai
变黑	bianhei
打包	dabao
公公	gonggong
没完	meiwan
软糖	ruantang
下著	xiazhu
点菜	diancai
交卷	jiaojuan
交代	jiaodai
第一课	diyike
大校	daxiao
跟去	genqu
游玩	youwan
出过	chuguo
没问	meiwen
说有	shuoyou
坐等	zuodeng
冷箱	lengxiang
看盘	kanpan
看比	kanbi
超爱	chaoai
渴得	kede
营业	yingye
客服	kefu
急诊室	jizhenshi
就诊	jiuzhen
进食	jinshi
诊断	zhenduan
产品检验	chanpinjianyan
卫生部门	weishengbumen
本市	benshi
含著	hanzhu
饭菜	fancai
打听	dating
贵局	guiju
公道	gongdao
保安员	baoanyuan
总经理	zongjingli
停骗	tingpian
卫生局长	weishengjuchang
食料	shiliao
资产	zichan
罚钱	faqian
骗财	piancai
骗色	pianse
极力	jili
宣称	xuancheng
朋友网	pengyouwang
用脑	yongnao
警戒	jingjie
行事	xingshi
权益	quanyi
步地	budi
居心	juxin
人文	renwen
大麻	dama
人用	renyong
吃亏	chikui
干部	ganbu
延到	yandao
幽灵	youling
换钱	huanqian
事儿	shier
丧礼	sangli
赶出去	ganchuqu
摆列	bailie
菊花	juhua
信件	xinjian
邀约	yaoyue
聚会	juhui
坦率	tanlv
出于	chuyu
起码	qima
遇过	yuguo
订书	dingshu
偷笑	touxiao
好骗	haopian
说成	shuocheng
棉被	mianbei
总比	zongbi
电子	dianzi
风俗习惯	fengsuxiguan
满著	manzhu
人格	renge
接电	jiedian
语调	yudiao
书局	shuju
依林	yilin
要钱	yaoqian
退货	tuihuo
选课	xuanke
祖恶	zue
恶境	ejing
分心	fenxin
逼迫	bipo
陷于	xianyu
血管	xieguan
分散	fensan
两门课	liangmenke
薰陶	xuntao
拿份	nafen
专业知识	zhuanyezhishi
管理工作	guanligongzuo
趋向	quxiang
修养	xiuyang
为生	weisheng
削弱	xueruo
成分	chengfen
夺取	duoqu
系所	xisuo
赚留	zhuanliu
跷课	qiaoke
新台币	xintaibi
累坏	leihuai
走得快	zoudekuai
现实生活	xianshishenghuo
不明	buming
付得	fude
付担	fudan
负得起	fudeqi
人品	renpin
交学费	jiaoxuefei
娱乐活动	yulehuodong
广告片	guanggaopian
高手	gaoshou
评选	pingxuan
可分	kefen
陌生人	moshengren
作弊	zuobi
想成	xiangcheng
写论	xielun
道歉	daoqian
落幕	luomu
男同学	nantongxue
毛病	maobing
通缉犯	tongjifan
菩萨	pusa
小兔	xiaotu
整件	zhengjian
伤痕	shanghen
委屈	weiqu
冤枉	yuanwang
澄清	chengqing
流逝	liushi
足迹	zuji
诬赖	wulai
失误	shiwu
改坐	gaizuo
先用	xianyong
倾诉	qingsu
光怪	guangguai
得罪	dezui
别怪	bieguai
留情面	liuqingmian
谴责	qianze
分辨	fenbian
误认为	wurenwei
疑务	yiwu
揭晓	jiexiao
讲信用	jiangxinyong
失礼	shili
平息	pingxi
放进去	fangjinqu
自造	zizao
热化	rehua
追根究底	zhuigenjiudi
生态系	shengtaixi
观逛	guanguang
旅游业	lvyouye
持有	chiyou
表明	biaoming
利处	lichu
服用药	fuyongyao
好出	haochu
弄掉	nongdiao
外地人	waidiren
下限	xiaxian
都市化	dushihua
重盖	zhonggai
反覆	fanfu
建筑物	jianzhuwu
人间仙境	renjianxianjing
气势	qishi
景观	jingguan
吸引力	xiyinli
胜于	shengyu
破害	pohai
油价	youjia
兼得	jiande
环景	huanjing
工业	gongye
覆辙	fuzhe
重蹈	zhongdao
饮水思源	yinshuisiyuan
义务	yiwu
滥伐	lanfa
热带雨林	redaiyulin
经济效益	jingjixiaoyi
崛起	jueqi
举例	juli
名义	mingyi
国防	guofang
飞跃	feiyue
局限	juxian
马铃薯	malingshu
料酒	liaojiu
小匙	xiaochi
独有	duyou
程序	chengxu
全鸡	quanji
脚跟	jiaogen
猪脚	zhujiao
说到	shuodao
芝麻酱	zhimajiang
要塞	yaosai
啤酒节	pijiujie
干季	ganji
加大	jiada
烤鱼	kaoyu
博士学位	boshixuewei
大工	dagong
并让	bingrang
会计	huiji
财务	caiwu
成本	chengben
系像	xixiang
还清	huanqing
优秀学生	youxiuxuesheng
可领	keling
商家	shangjia
求业	qiuye
反弹	fandan
养过	yangguo
疗护	liaohu
狗狗	gougou
完假	wanjia
商业化	shangyehua
首选	shouxuan
租狗	zugou
养狗	yanggou
因人	yinren
信用	xinyong
活生生	huoshengsheng
要害	yaohai
教育部门	jiaoyubumen
基本知识	jibenzhishi
框框	kuangkuang
心智	xinzhi
方程式	fangchengshi
授予	shouyu
放任	fangren
多变	duobian
风气	fengqi
儒家	rujia
盛行	shengxing
发起	faqi
自发	zifa
小孩儿	xiaohaier
电子业	dianziye
毁灭	huimie
房车	fangche
段落	duanluo
太阳能	taiyangneng
研究生	yanjiusheng
继子	jizi
后事	houshi
称羡	chengxian
雾水	wushui
不靠	bukao
就业机会	jiuyejihui
掏出	taochu
金融危机	jinrongweiji
硕士班	shuoshiban
理财	licai
外交系	waijiaoxi
打理	dali
事务	shiwu
事况	shikuang
公交	gongjiao
选伴	xuanban
择偶	zeou
嫁错	jiacuo
含泪	hanlei
实现理想	shixianlixiang
团员	tuanyuan
得少	deshao
省力	shengli
能生	nengsheng
办助有	banzhuyou
孕妇	yunfu
点点	diandian
班主任	banzhuren
经济学	jingjixue
文藻	wenzao
街友	jieyou
公益	gongyi
设施	sheshi
胸部	xiongbu
升职	shengzhi
主妇	zhufu
家当	jiadang
传统观念	chuantongguannian
感来	ganlai
看画	kanhua
窘境	jiongjing
沦落	lunluo
小看	xiaokan
干完	ganwan
找褓	zhaobao
空虚	kongxu
职位	zhiwei
余暇	yuxia
加增	jiazeng
名家	mingjia
外快	waikuai
死活	sihuo
著好	zhuhao
下让	xiarang
复苏	fusu
洋相	yangxiang
回归	huigui
奉献	fengxian
降薪	jiangxin
掠过	lveguo
借宿	jiesu
现况	xiankuang
预见	yujian
扭曲	niuqu
充电	chongdian
贫富差距	pinfuchaju
来电	laidian
分与	fenyu
筹备	choubei
水池	shuichi
撑著	chengzhu
轮椅	lunyi
滚动	gundong
水泥	shuini
成员	chengyuan
破算	posuan
外语	waiyu
油压	youya
交易	jiaoyi
登高	denggao
顺道	shundao
学士学位	xueshixuewei
甜汤	tiantang
算错	suancuo
解雇	jiegu
买房	maifang
集聚	jiju
捕鱼	buyu
为著	weizhu
视为	shiwei
营业额	yingyee
订单	dingdan
公务员	gongwuyuan
模式	moshi
地都	didu
电话费	dianhuafei
制裁	zhicai
平衡点	pinghengdian
充分利用	chongfenliyong
拉近	lajin
时空	shikong
界线	jiexian
虚拟	xuni
带坏	daihuai
社群	shequn
新页	xinye
阅读室	yuedushi
高于	gaoyu
考不上	kaobushang
聊上	liaoshang
以致于	yizhiyu
麻疹	mazhen
身体状况	shentizhuangkuang
抵抗力	dikangli
吩咐	fenfu
生活圈	shenghuoquan
区别	qubie
时学	shixue
用电	yongdian
所人	suoren
写错	xiecuo
来查	laicha
字典	zidian
萤幕	yingmu
失恋	shilian
播出	bochu
男生女生	nanshengnvsheng
上线	shangxian
视讯	shixun
热线	rexian
住宿	zhusu
科学技术	kexuejishu
优势	youshi
咖啡因	kafeiyin
异乡	yixiang
推厂	tuichang
咖店	kadian
色情	seqing
泄漏	xielou
持著	chizhu
网速	wangsu
色情网站	seqingwangzhan
特性	texing
作息	zuoxi
总结	zongjie
黄片	huangpian
便利化	bianlihua
有线网	youxianwang
看报	kanbao
无损	wusun
放宽	fangkuan
打中	dazhong
送上	songshang
滥用	lanyong
活出	huochu
胜败	shengbai
展开	zhankai
方所	fangsuo
区民	qumin
苍蝇	cangying
诉状	suzhuang
局面	jumian
防音	fangyin
废弃	feiqi
提针	tizhen
围周	weizhou
回收机	huishouji
水滤可机	shuilvkeji
壁板	biban
屋顶	wuding
睡眠不足	shuimianbuzu
做不了	zuobule
营业时间	yingyeshijian
预防	yufang
提案	tian
化学原料	huaxueyuanliao
乡村	xiangcun
邻长	linchang
请盖	qinggai
闹音	naoyin
纠纷	jiufen
家是	jiashi
吸著	xizhu
难受	nanshou
村子	cunzi
控诉	kongsu
诊所	zhensuo
症状	zhengzhuang
患者	huanzhe
开厂	kaichang
休厂	xiuchang
排烟	paiyan
住进	zhujin
茅坑	maokeng
可恶	kee
造纸	zaozhi
人付	renfu
产出	chanchu
减低	jiandi
贵厂	guichang
致函	zhihan
质询	zhixun
和解	hejie
难闻	nanwen
坦白	tanbai
会影	huiying
响到	xiangdao
爷奶	yenai
食品业	shipinye
隔音墙	geyinqiang
器机	qiji
除旧	chujiu
隔音设备	geyinshebei
处理费	chulifei
避开	bikai
替换	tihuan
时因	shiyin
座谈	zuotan
血压	xieya
保存	baocun
指定	zhiding
出厂	chuchang
排废	paifei
自救	zijiu
搜集	souji
司法	sifa
委员会	weiyuanhui
臭臭	chouchou
景况	jingkuang
公害	gonghai
氧气	yangqi
雅量	yaliang
两者	liangzhe
自问	ziwen
邻有	linyou
轮班	lunban
投诉	tousu
养出	yangchu
胃痛	weitong
买新	maixin
答信	daxin
建有	jianyou
市议员	shiyiyuan
市议会	shiyihui
工人	gongren
薰天	xuntian
公家	gongjia
耳塞	ersai
利金	lijin
起诉	qisu
老姓	laoxing
半径	banjing
工业区	gongyequ
封住	fengzhu
睡不著	shuibuzhu
告到	gaodao
谈不成	tanbucheng
比用	biyong
财物	caiwu
看重	kanzhong
预想	yuxiang
做作业	zuozuoye
早睡	zaoshui
环保署	huanbaoshu
药物	yaowu
隔墙	geqiang
敢换	ganhuan
居友	juyou
苦衷	kuzhong
吵吵闹闹	chaochaonaonao
密闭	mibi
用力	yongli
扶植	fuzhi
确保	quebao
改装	gaizhuang
来用	laiyong
校方	xiaofang
技术人员	jishurenyuan
防护	fanghu
关节	guanjie
打骂	dama
闲著	xianzhu
登入	dengru
得当	dedang
下张	xiazhang
情书	qingshu
选民	xuanmin
候选人	houxuanren
劳师动众	laoshidongzhong
电脑科技	diannaokeji
连线	lianxian
议题	yiti
世间	shijian
觉智	juezhi
用出	yongchu
办校	banxiao
极端	jiduan
洋娃娃	yangwawa
根麦	genmai
拍到	paidao
骆驼	luotuo
隐私权	yinsiquan
抚育	fuyu
会画	huihua
地限	dixian
忧虑	youlv
监视器	jianshiqi
敲门	qiaomen
心虚	xinxu
信众	xinzhong
早熟	zaoshu
炫耀	xuanyao
行使	xingshi
利弊	libi
录下	luxia
体罚	tifa
误解	wujie
相结合	xiangjiehe
精髓	jingsui
听不进去	tingbujinqu
捉弄	zhuonong
远离	yuanli
入梦	rumeng
欺凌	qiling
写念	xienian
方便性	fangbianxing
条例	tiaoli
抹灭	momie
不忍	buren
知件	zhijian
学有	xueyou
冒出来	maochulai
因果关系	yinguoguanxi
预算	yusuan
会费	huifei
盯人	dingren
讲有	jiangyou
聊解	liaojie
认不	renbu
瞪著	dengzhu
玩学	wanxue
教惯	jiaoguan
前夫	qianfu
管太	guantai
电脑化	diannaohua
