白蛾	bai e 
附赠品	fu zeng pin 
电池	dian chi 
美国华人	mei guo hua ren 
红包	hong bao 
连续剧	lian xu ju 
哲理	zhe li 
树叶	shu ye 
电话	dian hua 
录影机	lu ying ji 
西安	xi an 
好心	hao xin 
曼谷	man gu 
抗压性	kang ya xing 
马铃薯	ma ling shu 
杂志	za zhi 
温度	wen du 
亲戚	qin qi 
荷兰人	he lan ren 
抗日	kang ri 
假象	jia xiang 
女强人	nv qiang ren 
国文课	guo wen ke 
信件	xin jian 
蔬果	shu guo 
昆虫	kun chong 
师大附中	shi da fu zhong 
出家人	chu jia ren 
人民	ren min 
功夫片	gong fu pian 
长江	chang jiang 
调皮	tiao pi 
汉语	han yu 
宵夜	xiao ye 
土耳其	tu er qi 
青江	qing jiang 
电影	dian ying 
电玩	dian wan 
意思	yi si 
纤维	xian wei 
单人房	dan ren fang 
盒子	he zi 
睡衣	shui yi 
论文	lun wen 
右转	you zhuan 
汤尼	tang ni 
出租车	chu zu che 
摩斯	mo si 
新加坡政府	xin jia po zheng fu 
教师	jiao shi 
南韩	nan han 
源头	yuan tou 
上流社会	shang liu she hui 
主张	zhu zhang 
医疗	yi liao 
花都	hua dou 
猎人	lie ren 
员工	yuan gong 
澳洲	ao zhou 
泰语	tai yu 
台北市	tai bei shi 
地面	di mian 
权利	quan li 
热血	re xue 
新加坡	xin jia po 
状态	zhuang tai 
体制	ti zhi 
主持人	zhu chi ren 
逆境	ni jing 
衣物	yi wu 
领导人	ling dao ren 
月租	yue zu 
成分	cheng fen 
管道	guan dao 
卫生设备	wei sheng she bei 
圆山	yuan shan 
老家	lao jia 
学长	xue zhang 
光明	guang ming 
化学	hua xue 
马达	ma da 
前夫	qian fu 
晚班	wan ban 
音响	yin xiang 
大衣	da yi 
香味	xiang wei 
笑声	xiao sheng 
境界	jing jie 
国度	guo du 
二手烟	er shou yan 
温哥华	wen ge hua 
脖子	bo zi 
平地	ping di 
翅膀	chi bang 
精华	jing hua 
语调	yu diao 
患者	huan zhe 
枝叶	zhi ye 
专业	zhuan ye 
蒋介石	jiang jie shi 
绿油油	lv you you 
地铁	di tie 
佛教	fo jiao 
邮局	you ju 
意大利	yi da li 
证件	zheng jian 
音乐风格	yin yue feng ge 
包子	bao zi 
长辈	zhang bei 
朴金民	pu jin min 
秩序	zhi xu 
凉鞋	liang xie 
南美洲	nan mei zhou 
好孩子	hao hai zi 
学费	xue fei 
钟头	zhong tou 
师生关系	shi sheng guan xi 
日文	ri wen 
会议	hui yi 
医疗费	yi liao fei 
爱莎妮亚	ai sha ni ya 
糖醋鱼	tang cu yu 
经济社会	jing ji she hui 
游泳衣	you yong yi 
职业妇女	zhi ye fu nv 
佐贺	zuo he 
邮差	you chai 
交通费	jiao tong fei 
行程	xing cheng 
虾球	xia qiu 
晚会节目	wan hui jie mu 
话别	hua bie 
小草	xiao cao 
素菜	su cai 
人世间	ren shi jian 
研究生	yan jiu sheng 
英文系	ying wen xi 
佳芝	jia zhi 
监狱	jian yu 
香菜	xiang cai 
天明	tian ming 
铅笔	qian bi 
起司	qi si 
爱情片	ai qing pian 
时代	shi dai 
女主角	nv zhu jue 
师长	shi zhang 
拉斯维加斯	la si wei jia si 
法文	fa wen 
厄瓦	e wa 
天蓝色	tian lan se 
商机	shang ji 
书堆	shu dui 
红衫	hong shan 
恐龙	kong long 
因素	yin su 
心房	xin fang 
大都会	da du hui 
中亚	zhong ya 
柏林	bo lin 
升官	sheng guan 
平衡点	ping heng dian 
美国国防部	mei guo guo fang bu 
鞭炮	bian pao 
西文	xi wen 
课桌椅	ke zhuo yi 
粮食	liang shi 
布告栏	bu gao lan 
幼稚园	you zhi yuan 
亲和力	qin he li 
小岛	xiao dao 
导游	dao you 
塞纳河	sai na he 
主人	zhu ren 
史怀哲	shi huai zhe 
泡汤	pao tang 
人才	ren cai 
约旦河	yue dan he 
空房间	kong fang jian 
陈太太	chen tai tai 
移民	yi min 
污水	wu shui 
大马路	da ma lu 
速食店	su shi dian 
区域	qu yu 
黑手	hei shou 
顺境	shun jing 
黑板	hei ban 
座谈	zuo tan 
交易	jiao yi 
风潮	feng chao 
案例	an li 
奥地利	ao di li 
假话	jia hua 
钟情	zhong qing 
野兽	ye shou 
新鲜空气	xin xian kong qi 
菩萨	pu sa 
百货商店	bai huo shang dian 
设计师	she ji shi 
病者	bing zhe 
宽度	kuan du 
朗朗	lang lang 
刘德华	liu de hua 
赢家	ying jia 
北极冰	bei ji bing 
广开	guang kai 
闹钟	nao zhong 
口袋	kou dai 
台北	tai bei 
苦水	ku shui 
哈博	ha bo 
气息	qi xi 
半径	ban jing 
刮痕	gua hen 
李小姐	li xiao jie 
汽水	qi shui 
吴家	wu jia 
成都	cheng du 
演讲会	yan jiang hui 
外套	wai tao 
纽约	niu yue 
书本	shu ben 
普遍现象	pu bian xian xiang 
日式	ri shi 
心智	xin zhi 
消息	xiao xi 
欧洲区	ou zhou qu 
变数	bian shu 
慈安	ci an 
黄美丽	huang mei li 
上海	shang hai 
中巴	zhong ba 
冷气机	leng qi ji 
报纸	bao zhi 
动静	dong jing 
全世界	quan shi jie 
瑞典人	rui dian ren 
母语	mu yu 
过瘾	guo yin 
店长	dian zhang 
山西	shan xi 
衣柜	yi gui 
主因	zhu yin 
观想	guan xiang 
黑马	hei ma 
清汤	qing tang 
战友	zhan you 
双手	shuang shou 
电子辞典	dian zi ci dian 
好感	hao gan 
公共汽车	gong gong qi che 
家庭	jia ting 
脚印	jiao yin 
停车场	ting che chang 
全校	quan xiao 
西班牙文	xi ban ya wen 
平溪	ping xi 
学生会	xue sheng hui 
辞典	ci dian 
日本式	ri ben shi 
遮阳板	zhe yang ban 
小花	xiao hua 
棕色	zong se 
天空	tian kong 
光辉	guang hui 
啦啦队	la la dui 
市议员	shi yi yuan 
产业	chan ye 
水箱	shui xiang 
迪士尼	di shi ni 
日落	ri luo 
意志力	yi zhi li 
表店	biao dian 
肉片	rou pian 
习惯	xi guan 
广州	guang zhou 
资质	zi zhi 
电视新闻	dian shi xin wen 
天堂	tian tang 
紫外线	zi wai xian 
医药	yi yao 
营业额	ying ye e 
仲介	zhong jie 
澳大利亚	ao da li ya 
泰国	tai guo 
交通	jiao tong 
脑袋	nao dai 
乞丐	qi gai 
特质	te zhi 
雅虎	ya hu 
单位	dan wei 
新进人员	xin jin ren yuan 
天鹅	tian e 
西雅图	xi ya tu 
东南亚	dong nan ya 
课程	ke cheng 
新房子	xin fang zi 
保母	bao mu 
皮肤癌	pi fu ai 
国际学舍	guo ji xue she 
树梢	shu shao 
芝麻油	zhi ma you 
数学老师	shu xue lao shi 
女子	nv zi 
传说	chuan shuo 
塔里	ta li 
歌谱	ge pu 
骗术	pian shu 
下课铃	xia ke ling 
花莲人	hua lian ren 
年龄	nian ling 
太阳眼镜	tai yang yan jing 
工友	gong you 
台南	tai nan 
小游戏	xiao you xi 
待遇	dai yu 
敬佩	jing pei 
市议会	shi yi hui 
特色	te se 
课文	ke wen 
施明德	shi ming de 
天地	tian di 
家园	jia yuan 
哈利波	ha li bo 
概念	gai nian 
风采	feng cai 
孙中山	sun zhong shan 
服务员	fu wu yuan 
马桶	ma tong 
人家	ren jia 
普通	pu tong 
王永庆	wang yong qing 
目标	mu biao 
甜汤	tian tang 
纪录	ji lu 
歹徒	dai tu 
爱因斯坦	ai yin si tan 
寝室	qin shi 
海物	hai wu 
悲剧	bei ju 
雅房	ya fang 
题材	ti cai 
美玲	mei ling 
名胜	ming sheng 
引擎	yin qing 
窗户	chuang hu 
开户	kai hu 
热气	re qi 
喜雀	xi que 
妖怪	yao guai 
气象报告	qi xiang bao gao 
贷款	dai kuan 
光纤	guang xian 
智力	zhi li 
约翰	yue han 
意识	yi shi 
耶稣	ye su 
花费	hua fei 
光阴	guang yin 
餐店	can dian 
警方	jing fang 
点菜	dian cai 
外衣	wai yi 
外交部	wai jiao bu 
官员	guan yuan 
小巷	xiao xiang 
交响曲	jiao xiang qu 
导师	dao shi 
户外活动	hu wai huo dong 
服饰	fu shi 
平民	ping min 
雕刻	diao ke 
发票	fa piao 
第一次世界大战	di yi ci shi jie da zhan 
儿童	er tong 
笨蛋	ben dan 
水资源	shui zi yuan 
邻居们	lin ju men 
洗手间	xi shou jian 
国际交流	guo ji jiao liu 
摊子	tan zi 
漫画书	man hua shu 
保安	bao an 
早饭	zao fan 
白人	bai ren 
家当	jia dang 
航空公司	hang kong gong si 
教会	jiao hui 
外人	wai ren 
下学期	xia xue qi 
大王	dai wang 
角度	jiao du 
写者	xie zhe 
月光	yue guang 
走廊	zou lang 
史迪威	shi di wei 
大明	da ming 
中美关系	zhong mei guan xi 
保险费	bao xian fei 
广东	guang dong 
业务	ye wu 
时侯	shi hou 
宫保鸡	gong bao ji 
畸形儿	ji xing er 
钥匙孔	yao shi kong 
名义	ming yi 
污垢	wu gou 
大众	da zhong 
水电费	shui dian fei 
东京	dong jing 
国家	guo jia 
健身房	jian shen fang 
作业本	zuo ye ben 
同班同学	tong ban tong xue 
普及化	pu ji hua 
费雨嫱	fei yu qiang 
牌子	pai zi 
威尼斯	wei ni si 
林依晨	lin yi chen 
巴拿马	ba na ma 
西班牙	xi ban ya 
口角	kou jue 
三里屯	san li tun 
未婚妻	wei hun qi 
心理准备	xin li zhun bei 
球赛	qiu sai 
电视	dian shi 
医院	yi yuan 
外太空	wai tai kong 
座号	zuo hao 
摩托车	mo tuo che 
心愿	xin yuan 
外籍人士	wai ji ren shi 
纽西兰	niu xi lan 
眼镜	yan jing 
学校	xue xiao 
战利品	zhan li pin 
房屋	fang wu 
小朋友	xiao peng you 
舞姿	wu zi 
大事	da shi 
午饭	wu fan 
忠孝东路	zhong xiao dong lu 
萧美	xiao mei 
考试卷	kao shi juan 
装影机	zhuang ying ji 
大风大浪	da feng da lang 
宠物医院	chong wu yi yuan 
英文	ying wen 
音乐厅	yin yue ting 
樱花	ying hua 
天妇罗	tian fu luo 
无线网	wu xian wang 
经纪人	jing ji ren 
医师	yi shi 
晚安	wan an 
冰岛	bing dao 
世界大战	shi jie da zhan 
影城	ying cheng 
教育费	jiao yu fei 
比方	bi fang 
菜药	cai yao 
传记	zhuan ji 
萝卜	luo bo 
极品	ji pin 
虚拟世界	xu ni shi jie 
植物	zhi wu 
市长	shi zhang 
公交	gong jiao 
隐私权	yin si quan 
摩洛哥	mo luo ge 
正值	zheng zhi 
经济负担	jing ji fu dan 
叶问	ye wen 
长城	chang cheng 
书面	shu mian 
篮板	lan ban 
教材	jiao cai 
男性	nan xing 
动脑筋	dong nao jin 
大学	da xue 
文凭	wen ping 
财产	cai chan 
市中心	shi zhong xin 
天兵	tian bing 
神经病	shen jing bing 
新竹市	xin zhu shi 
百货公司	bai huo gong si 
功能	gong neng 
巴西	ba xi 
国民军	guo min jun 
硬体	ying ti 
天生	tian sheng 
公共交通	gong gong jiao tong 
中华电信	zhong hua dian xin 
手脚	shou jiao 
标志	biao zhi 
泸器	lu qi 
冰店	bing dian 
教学方法	jiao xue fang fa 
玄奘	xuan zang 
演戏	yan xi 
外语学院	wai yu xue yuan 
餐厅	can ting 
的士	di shi 
贡献	gong xian 
以色列	yi se lie 
时数	shi shu 
冷箱	leng xiang 
出生率	chu sheng lv 
扫帚	sao zhou 
项目	xiang mu 
精英	jing ying 
小飞侠	xiao fei xia 
内心	nei xin 
大华	da hua 
民进党	min jin dang 
传授	chuan shou 
悟空	wu kong 
水果皮	shui guo pi 
原则	yuan ze 
美式	mei shi 
座谈会	zuo tan hui 
印尼语	yin ni yu 
永安	yong an 
总经理	zong jing li 
公告栏	gong gao lan 
驱动器	qu dong qi 
人口数量	ren kou shu liang 
饮水思源	yin shui si yuan 
华侨	hua qiao 
武侯	wu hou 
实例	shi li 
阮元	ruan yuan 
汽运	qi yun 
月经	yue jing 
高压电	gao ya dian 
服装店	fu zhuang dian 
知识者	zhi shi zhe 
体积	ti ji 
机票	ji piao 
桌球	zhuo qiu 
敦化	dun hua 
创新能力	chuang xin neng li 
饭菜	fan cai 
毕卡索	bi ka suo 
剧情	ju qing 
全球	quan qiu 
上帝	shang di 
中信	zhong xin 
教学法	jiao xue fa 
市民	shi min 
德明	de ming 
外语	wai yu 
多姿	duo zi 
酒肉朋友	jiu rou peng you 
国画	guo hua 
分表	fen biao 
难题	nan ti 
班级	ban ji 
白马王子	bai ma wang zi 
棉被	mian bei 
技巧	ji qiao 
德文	de wen 
关西	guan xi 
嘴唇	zui chun 
挚爱	zhi ai 
足球场	zu qiu chang 
问候	wen hou 
皱纹	zhou wen 
实验室	shi yan shi 
气象	qi xiang 
聚会	ju hui 
国文	guo wen 
花莲县	hua lian xian 
汉字	han zi 
高龄	gao ling 
音乐学校	yin yue xue xiao 
帽子	mao zi 
中心	zhong xin 
楼顶	lou ding 
眼帘	yan lian 
法国菜	fa guo cai 
句点	ju dian 
正妹	zheng mei 
念头	nian tou 
文化路	wen hua lu 
家具	jia ju 
棒球员	bang qiu yuan 
专案	zhuan an 
酱油	jiang you 
旅游业	lv you ye 
手续费	shou xu fei 
美食家	mei shi jia 
物柜	wu gui 
双床	shuang chuang 
杨赵宁	yang zhao ning 
时刻	shi ke 
学系	xue xi 
生命力	sheng ming li 
机率	ji lv 
百货	bai huo 
脚跟	jiao gen 
历史课	li shi ke 
才子	cai zi 
社会学	she hui xue 
国手	guo shou 
黄立己	huang li ji 
客厅	ke ting 
毒蛇	du she 
徒弟	tu di 
炒年糕	chao nian gao 
吕秀莲	lv xiu lian 
钱柜	qian gui 
海流	hai liu 
龙门	long men 
剑术	jian shu 
经验	jing yan 
河跟园	he gen yuan 
台湾大学	tai wan da xue 
宫崎骏	gong qi jun 
军人	jun ren 
鱼群	yu qun 
苍穹	cang qiong 
主妇	zhu fu 
菲律宾	fei lv bin 
新闻报导	xin wen bao dao 
堂兄弟	tang xiong di 
晚餐	wan can 
亮眼	liang yan 
时光	shi guang 
烧炭	shao tan 
心理	xin li 
扑克牌	pu ke pai 
冲浪板	chong lang ban 
窝心	wo xin 
钻石	zuan shi 
国小	guo xiao 
香港	xiang gang 
纪念品	ji nian pin 
造句	zao ju 
蛋糕	dan gao 
桃红色	tao hong se 
方程式	fang cheng shi 
厨余桶	chu yu tong 
机关	ji guan 
台北人	tai bei ren 
品牌服饰	pin pai fu shi 
乐谱	yue pu 
墨西哥	mo xi ge 
职位	zhi wei 
所有物	suo you wu 
作业员	zuo ye yuan 
英国人	ying guo ren 
大康	da kang 
名言	ming yan 
讲义	jiang yi 
观众	guan zhong 
现代文学	xian dai wen xue 
球队	qiu dui 
劳力	lao li 
小票	xiao piao 
李大伟	li da wei 
省事	sheng shi 
资讯	zi xun 
巴黎	ba li 
会费	hui fei 
枕头	zhen tou 
网速	wang su 
诸葛亮	zhu ge liang 
疗养院	liao yang yuan 
宜兰	yi lan 
本性	ben xing 
明洞	ming dong 
学妹	xue mei 
风雨	feng yu 
笼子	long zi 
海龟	hai gui 
社会科学	she hui ke xue 
校外活动	xiao wai huo dong 
保安员	bao an yuan 
志玲	zhi ling 
班导	ban dao 
琐事	suo shi 
鼎泰丰	ding tai feng 
意志	yi zhi 
海啸	hai xiao 
英语	ying yu 
伟大成就	wei da cheng jiu 
红衣服	hong yi fu 
日本国	ri ben guo 
白色	bai se 
功力	gong li 
永和	yong he 
饺子	jiao zi 
规划	gui hua 
人生目标	ren sheng mu biao 
高歌	gao ge 
卡拉	ka la 
茅坑	mao keng 
赏画	shang hua 
程度	cheng du 
路标	lu biao 
红楼	hong lou 
秋桂	qiu gui 
蜜粉	mi fen 
开场	kai chang 
财政支出	cai zheng zhi chu 
大桥	da qiao 
巨轮	ju lun 
盛情	sheng qing 
原地	yuan di 
人口统计	ren kou tong ji 
胖子	pang zi 
建筑	jian zhu 
病患	bing huan 
产品	chan pin 
唐太宗	tang tai zong 
货币	huo bi 
功课	gong ke 
定义	ding yi 
烤鸡	kao ji 
话题	hua ti 
头发	tou fa 
林小安	lin xiao an 
残叶	can ye 
尼克	ni ke 
祈福	qi fu 
小角色	xiao jiao se 
张湖	zhang hu 
海关	hai guan 
游览车	you lan che 
培根	pei gen 
花束	hua shu 
面包	mian bao 
温室效应	wen shi xiao ying 
城煌	cheng huang 
阿根廷	a gen ting 
印度	yin du 
口香糖	kou xiang tang 
志愿	zhi yuan 
永康	yong kang 
稳定度	wen ding du 
纸条	zhi tiao 
读书	du shu 
胶水	jiao shui 
日本料理	ri ben liao li 
教育界	jiao yu jie 
林志玲	lin zhi ling 
广告	guang gao 
寺庙	si miao 
男子	nan zi 
雨伞	yu san 
老幼	lao you 
关系	guan xi 
旧金山	jiu jin shan 
火箭	huo jian 
马德里	ma de li 
人间仙境	ren jian xian jing 
工作效率	gong zuo xiao lv 
山间	shan jian 
布希	bu xi 
内蒙古	nei meng gu 
三国演义	san guo yan yi 
文教	wen jiao 
景气	jing qi 
信义路	xin yi lu 
现状	xian zhuang 
照片	zhao pian 
作息	zuo xi 
中明	zhong ming 
荷兰文	he lan wen 
模型	mo xing 
科技时代	ke ji shi dai 
小鸟	xiao niao 
原料	yuan liao 
垃圾桶	la ji tong 
名称	ming cheng 
商品	shang pin 
部落	bu luo 
雨鞋	yu xie 
条例	tiao li 
情人	qing ren 
房仲	fang zhong 
李明德	li ming de 
排球	pai qiu 
配角	pei jue 
外籍人	wai ji ren 
联合国	lian he guo 
噪音	zao yin 
邀请卡	yao qing ka 
柯南	ke nan 
气味	qi wei 
负荷	fu he 
医术	yi shu 
号码	hao ma 
乌克兰	wu ke lan 
份子	fen zi 
风纪	feng ji 
便宜货	pian yi huo 
客户	ke hu 
澳门	ao men 
和平西路	he ping xi lu 
美金	mei jin 
新表	xin biao 
便利商店	bian li shang dian 
物件	wu jian 
日语	ri yu 
凉面	liang mian 
独生子女	du sheng zi nv 
个数	ge shu 
农场	nong chang 
颜色	yan se 
裤子	ku zi 
联络簿	lian luo bu 
殿堂	dian tang 
关卡	guan qia 
外长	wai zhang 
潮流	chao liu 
音效	yin xiao 
出厂	chu chang 
芬多	fen duo 
校花	xiao hua 
父亲	fu qin 
防音	fang yin 
年青人	nian qing ren 
臭豆腐	chou dou fu 
太极拳	tai ji quan 
老鼠	lao shu 
场合	chang he 
窗台	chuang tai 
大陆	da lu 
墨尔本	mo er ben 
范围	fan wei 
中毒	zhong du 
荷兰	he lan 
蜘蛛人	zhi zhu ren 
灵山	ling shan 
戏码	xi ma 
院子	yuan zi 
凉意	liang yi 
桌角	zhuo jiao 
热带雨林	re dai yu lin 
作品	zuo pin 
马丁	ma ding 
西洋	xi yang 
录音带	lu yin dai 
林达	lin da 
节奏感	jie zou gan 
住院	zhu yuan 
脾气	pi qi 
前途	qian tu 
日本	ri ben 
大局	da ju 
小事	xiao shi 
男同学	nan tong xue 
救护车	jiu hu che 
演奏家	yan zou jia 
字画	zi hua 
糕点	gao dian 
字眼	zi yan 
飞弹	fei dan 
富士山	fu shi shan 
隧道	sui dao 
小礼堂	xiao li tang 
玄奘大师	xuan zang da shi 
国民党	guo min dang 
信心	xin xin 
高雄明	gao xiong ming 
大餐	da can 
灰色	hui se 
政治	zheng zhi 
低收入	di shou ru 
音乐大师	yin yue da shi 
大楼	da lou 
偶像剧	ou xiang ju 
王家	wang jia 
观点	guan dian 
电厂	dian chang 
心酸	xin suan 
权力	quan li 
博士	bo shi 
杂事	za shi 
凯勒	kai lei 
慕尼黑	mu ni hei 
成语	cheng yu 
林先生	lin xian sheng 
补款	bu kuan 
新衣	xin yi 
品德	pin de 
李陵	li ling 
动物园	dong wu yuan 
俄罗斯	e luo si 
座椅	zuo yi 
花草	hua cao 
美容室	mei rong shi 
身心	shen xin 
酒吧	jiu ba 
妻子	qi zi 
千金	qian jin 
肚子	du zi 
平台	ping tai 
司马迁	si ma qian 
约会	yue hui 
时间	shi jian 
陶渊明	tao yuan ming 
草稿	cao gao 
管弦乐团	guan xian yue tuan 
炸鸡	zha ji 
书法	shu fa 
税金	shui jin 
箱子	xiang zi 
体育课	ti yu ke 
电影片	dian ying pian 
大湖	da hu 
加州	jia zhou 
品牌	pin pai 
好运	hao yun 
暖气	nuan qi 
树枝	shu zhi 
诀窍	jue qiao 
梵谷	fan gu 
南澳	nan ao 
新娘	xin niang 
历史	li shi 
火车	huo che 
杜拜	du bai 
坏习惯	huai xi guan 
高度	gao du 
高龄产妇	gao ling chan fu 
证券公司	zheng quan gong si 
垃圾筒	la ji tong 
结婚年龄	jie hun nian ling 
短片	duan pian 
炉子	lu zi 
水泥	shui ni 
秀英	xiu ying 
福利制度	fu li zhi du 
台币	tai bi 
个子	ge zi 
新闻台	xin wen tai 
泰国人	tai guo ren 
原住民	yuan zhu min 
饼干	bing gan 
叶瓣	ye ban 
地球	di qiu 
馒头	man tou 
名片	ming pian 
李希平	li xi ping 
大坂	da ban 
赵又廷	zhao you ting 
运动场	yun dong chang 
环游世界	huan you shi jie 
排队	pai dui 
公式	gong shi 
周健华	zhou jian hua 
学子	xue zi 
绊脚石	ban jiao shi 
暴风	bao feng 
家政	jia zheng 
狗狗	gou gou 
秘鲁	bi lu 
李安	li an 
蜘蛛	zhi zhu 
大地	da di 
房东太太	fang dong tai tai 
工作量	gong zuo liang 
晚饭	wan fan 
陌生	mo sheng 
起跑点	qi pao dian 
宿舍	su she 
陆生	lu sheng 
眼神	yan shen 
辣味	la wei 
红色	hong se 
信念	xin nian 
生气	sheng qi 
拖把	tuo ba 
地学	di xue 
金字塔	jin zi ta 
松山	song shan 
正路	zheng lu 
沙发	sha fa 
成绩单	cheng ji dan 
机器	ji qi 
黑色	hei se 
海水	hai shui 
偏远地区	pian yuan di qu 
穴道	xue dao 
计划	ji hua 
根源	gen yuan 
郑丰喜	zheng feng xi 
小巷子	xiao xiang zi 
烤鱼	kao yu 
夫妻	fu qi 
声调	sheng diao 
捷克	jie ke 
卡通片	ka tong pian 
画表	hua biao 
事故	shi gu 
景美	jing mei 
洗衣机	xi yi ji 
亚洲	ya zhou 
白酒	bai jiu 
敦化北路	dun hua bei lu 
补习班	bu xi ban 
陌生人	mo sheng ren 
棍子	gun zi 
烧肉	shao rou 
新发明	xin fa ming 
跑腿	pao tui 
艾伦	ai lun 
下雨天	xia yu tian 
科系	ke xi 
米兰队	mi lan dui 
落叶	luo ye 
高速铁路	gao su tie lu 
枝干	zhi gan 
歌手	ge shou 
鲸鲨	jing sha 
主管	zhu guan 
美国大学	mei guo da xue 
警察局	jing cha ju 
泪珠	lei zhu 
外表	wai biao 
理性	li xing 
亚马逊	ya ma xun 
印中	yin zhong 
女孩子	nv hai zi 
语言	yu yan 
越南人	yue nan ren 
目的地	mu di di 
球桌	qiu zhuo 
友人	you ren 
母狮	mu shi 
爱沙尼亚	ai sha ni ya 
别林斯基	bie lin si ji 
衣架	yi jia 
建筑物	jian zhu wu 
基隆	ji long 
步伐	bu fa 
爱情	ai qing 
学位	xue wei 
衣着	yi zhuo 
德蕾	de lei 
明灯	ming deng 
古人	gu ren 
泰式	tai shi 
表妹	biao mei 
旅途	lv tu 
身体	shen ti 
被害人	bei hai ren 
王哲明	wang zhe ming 
色情	se qing 
神医	shen yi 
寒风	han feng 
文德	wen de 
母子情	mu zi qing 
桌子	zhuo zi 
地点	di dian 
病魔	bing mo 
建康	jian kang 
犯人	fan ren 
名誉	ming yu 
凯旋门	kai xuan men 
坏消息	huai xiao xi 
办理	ban li 
税率	shui lv 
名词	ming ci 
陈爱明	chen ai ming 
罗东	luo dong 
筹码	chou ma 
锻带	duan dai 
学士学位	xue shi xue wei 
礼物	li wu 
马英九	ma ying jiu 
论点	lun dian 
游民	you min 
洗澡间	xi zao jian 
芒果	mang guo 
学术	xue shu 
万物	wan wu 
大象	da xiang 
专柜	zhuan gui 
笑话	xiao hua 
体操比赛	ti cao bi sai 
淡水	dan shui 
电脑公司	dian nao gong si 
高铁	gao tie 
围周	wei zhou 
教室	jiao shi 
好客	hao ke 
空气	kong qi 
孩子	hai zi 
十全十美	shi quan shi mei 
报酬率	bao chou lv 
电力	dian li 
名模	ming mo 
居士	ju shi 
棒球	bang qiu 
纹理	wen li 
澎湖	peng hu 
产假	chan jia 
症状	zheng zhuang 
中文	zhong wen 
塑胶	su jiao 
美景	mei jing 
消费者	xiao fei zhe 
瓶罐	ping guan 
泪水	lei shui 
商业	shang ye 
阿华	a hua 
保安人员	bao an ren yuan 
卡通	ka tong 
铁塔	tie ta 
游戏	you xi 
学问	xue wen 
指纹	zhi wen 
德国	de guo 
超级市场	chao ji shi chang 
食物	shi wu 
记忆力	ji yi li 
中学	zhong xue 
污点	wu dian 
古城堡	gu cheng bao 
方大同	fang da tong 
环岛	huan dao 
彩虹	cai hong 
陈先生	chen xian sheng 
距离感	ju li gan 
学业	xue ye 
宁静	ning jing 
书香	shu xiang 
男朋友	nan peng you 
收音机	shou yin ji 
资源	zi yuan 
风景	feng jing 
国语	guo yu 
戏剧	xi ju 
耳塞	er sai 
南丁格尔	nan ding ge er 
善念	shan nian 
小树	xiao shu 
政绩	zheng ji 
表象	biao xiang 
儿话	er hua 
工业革命	gong ye ge ming 
功夫	gong fu 
司机	si ji 
听力	ting li 
敌国	di guo 
班会	ban hui 
誓言	shi yan 
西班牙语	xi ban ya yu 
星星	xing xing 
眼光	yan guang 
佣人	yong ren 
耳边风	er bian feng 
养女	yang nv 
方法	fang fa 
心志	xin zhi 
张卫健	zhang wei jian 
黄山	huang shan 
圣文森	sheng wen sen 
人生道路	ren sheng dao lu 
扇子	shan zi 
代理商	dai li shang 
老套	lao tao 
北京动物园	bei jing dong wu yuan 
巨人	ju ren 
疾病	ji bing 
租税	zu shui 
课室	ke shi 
金句	jin ju 
电视节目	dian shi jie mu 
生物	sheng wu 
渔人	yu ren 
质料	zhi liao 
客房	ke fang 
利益	li yi 
喷泉	pen quan 
全面	quan mian 
运动鞋	yun dong xie 
贝多芬	bei duo fen 
鸟语花香	niao yu hua xiang 
渡边	du bian 
棋盘	qi pan 
监视器	jian shi qi 
极端派	ji duan pai 
李伟	li wei 
梁山伯	liang shan bo 
泡面	pao mian 
鼻子	bi zi 
云朵	yun duo 
气势	qi shi 
血缘	xue yuan 
台湾	tai wan 
国立大学	guo li da xue 
创造性	chuang zao xing 
鬼屋	gui wu 
吉他手	ji ta shou 
黄美真	huang mei zhen 
绰号	chuo hao 
马来西亚	ma lai xi ya 
茶馆	cha guan 
多明尼加	duo ming ni jia 
里弄	li long 
歌剧院	ge ju yuan 
钢琴	gang qin 
补贴	bu tie 
研究所	yan jiu suo 
传奇	chuan qi 
饮料	yin liao 
地铁站	di tie zhan 
桌脚	zhuo jiao 
水煎包	shui jian bao 
误会	wu hui 
大使	da shi 
李台生	li tai sheng 
蔡依林	cai yi lin 
插曲	cha qu 
踏板	ta ban 
姑母	gu mu 
总数	zong shu 
错事	cuo shi 
大学生	da xue sheng 
神灯	shen deng 
阿拉丁	a la ding 
工程师	gong cheng shi 
动手	dong shou 
垃圾	la ji 
午餐	wu can 
文藻	wen zao 
舞会	wu hui 
年糕	nian gao 
名列	ming lie 
小窝	xiao wo 
蜜蜂	mi feng 
空军	kong jun 
涂鸦	tu ya 
双亲	shuang qin 
野猪	ye zhu 
小笼包	xiao long bao 
数字	shu zi 
台中	tai zhong 
信任	xin ren 
名牌	ming pai 
天桥	tian qiao 
公寓	gong yu 
家乐福	jia le fu 
高科技	gao ke ji 
萧邦	xiao bang 
波兰人	bo lan ren 
坏事	huai shi 
加拿大人	jia na da ren 
芬兰人	fen lan ren 
英台	ying tai 
黑炭	hei tan 
伊坂幸	yi ban xing 
真理	zhen li 
柜子	gui zi 
坤山	kun shan 
歌喉	ge hou 
现金	xian jin 
战争	zhan zheng 
价值观	jia zhi guan 
晚婚	wan hun 
总结	zong jie 
隔音设备	ge yin she bei 
阴德	yin de 
监牢	jian lao 
楼梯	lou ti 
住民	zhu min 
利弊	li bi 
图书馆	tu shu guan 
陈老师	chen lao shi 
粉红色	fen hong se 
麻疹	ma zhen 
石头	shi tou 
英国	ying guo 
大使馆	da shi guan 
好帮手	hao bang shou 
天数	tian shu 
洛矶山	luo ji shan 
洋基队	yang ji dui 
周杰伦	zhou jie lun 
方向盘	fang xiang pan 
日月潭	ri yue tan 
继子	ji zi 
短剧	duan ju 
缺口	que kou 
飞轮海	fei lun hai 
校方	xiao fang 
足球队	zu qiu dui 
日本政府	ri ben zheng fu 
饭馆	fan guan 
说书人	shuo shu ren 
女友	nv you 
天主教	tian zhu jiao 
卧房	wo fang 
动机	dong ji 
西门町	xi men ting 
读者	du zhe 
盘子	pan zi 
传统	chuan tong 
无尾熊	wu wei xiong 
国乐团	guo le tuan 
叉路	cha lu 
主意	zhu yi 
碗筷	wan kuai 
鸡蛋	ji dan 
团体	tuan ti 
岗位	gang wei 
检察官	jian cha guan 
空格	kong ge 
成绩	cheng ji 
租费	zu fei 
小组	xiao zu 
考试成绩	kao shi cheng ji 
房价	fang jia 
负责人	fu ze ren 
菜色	cai se 
春水	chun shui 
故宫博物院	gu gong bo wu yuan 
椅子	yi zi 
机车	ji che 
越南	yue nan 
第三者	di san zhe 
演讲比赛	yan jiang bi sai 
汽车	qi che 
对象	dui xiang 
印度人	yin du ren 
电器店	dian qi dian 
果蝇	guo ying 
桌面	zhuo mian 
文具	wen ju 
民权	min quan 
国人	guo ren 
生态	sheng tai 
核能	he neng 
故事	gu shi 
高分	gao fen 
成龙	cheng long 
二郎	er lang 
鲁宾斯坦	lu bin si tan 
太鲁阁	tai lu ge 
新竹人	xin zhu ren 
龟苓膏	gui ling gao 
罗曼蒂克	luo man di ke 
讲桌	jiang zhuo 
大浪	da lang 
金文	jin wen 
巨作	ju zuo 
圈叉	quan cha 
臭味	chou wei 
爱妾	ai qie 
职场	zhi chang 
师范大学	shi fan da xue 
王大卫	wang da wei 
摄影机	she ying ji 
圣人	sheng ren 
午休	wu xiu 
业务员	ye wu yuan 
夏威夷	xia wei yi 
和服	he fu 
作弊	zuo bi 
伟人	wei ren 
公理	gong li 
生物课	sheng wu ke 
道路	dao lu 
图片	tu pian 
希腊	xi la 
光碟	guang die 
兔子	tu zi 
阮氏英	ruan shi ying 
好消息	hao xiao xi 
饮茶	yin cha 
压力	ya li 
律师	lv shi 
情景	qing jing 
小强	xiao qiang 
有机	you ji 
三鹿	san lu 
绿色	lv se 
意味	yi wei 
皮包	pi bao 
屋子	wu zi 
三角形	san jiao xing 
句型	ju xing 
前辈	qian bei 
视野	shi ye 
美味	mei wei 
星光	xing guang 
金融	jin rong 
心事	xin shi 
见面会	jian mian hui 
广告片	guang gao pian 
团圆	tuan yuan 
金城武	jin cheng wu 
班主任	ban zhu ren 
岔路	cha lu 
隔音	ge yin 
口号	kou hao 
身子	shen zi 
电梯	dian ti 
音乐教室	yin yue jiao shi 
死神	si shen 
人员	ren yuan 
情报	qing bao 
小说	xiao shuo 
淡蓝色	dan lan se 
猪脚	zhu jiao 
火烧	huo shao 
橄榄油	gan lan you 
天分	tian fen 
佛罗伦	fu luo lun 
酒店	jiu dian 
文化背景	wen hua bei jing 
睫毛	jie mao 
歌词	ge ci 
房租	fang zu 
观光事业	guan guang shi ye 
布朗	bu lang 
裙子	qun zi 
专科	zhuan ke 
祝英台	zhu ying tai 
公共场所	gong gong chang suo 
作者	zuo zhe 
时空	shi kong 
德国人	de guo ren 
新字	xin zi 
情书	qing shu 
卫生局长	wei sheng ju zhang 
动植物	dong zhi wu 
欧洲	ou zhou 
零用钱	ling yong qian 
专长	zhuan chang 
小组长	xiao zu zhang 
废话	fei hua 
野草	ye cao 
卫生局	wei sheng ju 
飞车	fei che 
人口数	ren kou shu 
非洲	fei zhou 
家务	jia wu 
娘家	niang jia 
道别	dao bie 
专业人士	zhuan ye ren shi 
儒家	ru jia 
情人节	qing ren jie 
机能	ji neng 
小孩	xiao hai 
法国电影	fa guo dian ying 
新竹	xin zhu 
先生	xian sheng 
婚姻	hun yin 
方案	fang an 
淡水河	dan shui he 
宝物	bao wu 
尔汤尼	er tang ni 
苏菲	su fei 
果汁	guo zhi 
游玩	you wan 
自卑	zi bei 
脏乱	zang luan 
谎话	huang hua 
被害者	bei hai zhe 
农村	nong cun 
咖哩鸡	ka li ji 
要素	yao su 
十九世纪	shi jiu shi ji 
手绘	shou hui 
背景	bei jing 
体型	ti xing 
肠粉	chang fen 
星巴克	xing ba ke 
新世界	xin shi jie 
橘黄色	ju huang se 
熟人	shu ren 
晴天	qing tian 
手机号码	shou ji hao ma 
踪迹	zong ji 
纺织业	fang zhi ye 
素描	su miao 
深绿色	shen lv se 
王建明	wang jian ming 
评分	ping fen 
孔子	kong zi 
清水	qing shui 
心肝宝贝	xin gan bao bei 
科技	ke ji 
长大成人	zhang da cheng ren 
散步	san bu 
四川	si chuan 
手表	shou biao 
大安区	da an qu 
笑容	xiao rong 
订单	ding dan 
王建民	wang jian min 
儿童节	er tong jie 
生产率	sheng chan lv 
纠纷	jiu fen 
民族	min zu 
剧团	ju tuan 
眼眶	yan kuang 
海伦	hai lun 
衣服	yi fu 
成本	cheng ben 
花莲	hua lian 
才学	cai xue 
趣味	qu wei 
景点	jing dian 
水准	shui zhun 
秀才	xiu cai 
台南市	tai nan shi 
电影票	dian ying piao 
齐天大圣	qi tian da sheng 
同学	tong xue 
味道	wei dao 
科学课	ke xue ke 
迷宫	mi gong 
英文书	ying wen shu 
林小美	lin xiao mei 
焦点	jiao dian 
雅虎公司	ya hu gong si 
雅加达	ya jia da 
大哥	da ge 
阅读者	yue du zhe 
物理学	wu li xue 
二十世纪	er shi shi ji 
缅甸人	mian dian ren 
身躯	shen qu 
政治经济	zheng zhi jing ji 
洛杉矶	luo shan ji 
海伦凯勒	hai lun kai lei 
蒸饭箱	zheng fan xiang 
音浪	yin lang 
昆山	kun shan 
王牌	wang pai 
波兰文	bo lan wen 
东西连	dong xi lian 
养老院	yang lao yuan 
笑靥	xiao ye 
火花	huo hua 
南德	nan de 
妇女	fu nv 
褐色	he se 
恐怖电影	kong bu dian ying 
第二世界	di er shi jie 
表哥	biao ge 
麦当劳	mai dang lao 
老师	lao shi 
皇天	huang tian 
阴影	yin ying 
小吃	xiao chi 
电视剧	dian shi ju 
内脏	nei zang 
泰顺街	tai shun jie 
段落	duan luo 
海浪	hai lang 
音乐家	yin yue jia 
周幽王	zhou you wang 
娱乐活动	yu le huo dong 
佛经	fo jing 
买菜	mai cai 
学院	xue yuan 
茶田	cha tian 
心态	xin tai 
球场	qiu chang 
电影机	dian ying ji 
高中同学	gao zhong tong xue 
扶轮社	fu lun she 
中华	zhong hua 
娃娃	wa wa 
公家	gong jia 
电话费	dian hua fei 
任务	ren wu 
飞镖	fei biao 
公路	gong lu 
聚精会神	ju jing hui shen 
股票	gu piao 
方型	fang xing 
风范	feng fan 
玩伴	wan ban 
早生贵子	zao sheng gui zi 
漫画	man hua 
黑糖	hei tang 
钻研	zuan yan 
筷子	kuai zi 
苏格拉底	su ge la di 
国乐社	guo le she 
李建国	li jian guo 
啤酒	pi jiu 
好事	hao shi 
男主	nan zhu 
工程	gong cheng 
好乐迪	hao le di 
禁药	jin yao 
住宿	zhu su 
风俗习惯	feng su xi guan 
文采	wen cai 
破洞	po dong 
景观	jing guan 
阿拉斯加	a la si jia 
瓦斯	wa si 
福特	fu te 
公立学校	gong li xue xiao 
银色	yin se 
丧气	sang qi 
热水	re shui 
陈汉典	chen han dian 
食粮	shi liang 
事俗	shi su 
恐怖分子	kong bu fen zi 
商业化	shang ye hua 
课题	ke ti 
育幼院	yu you yuan 
陈文茜	chen wen qian 
羊肉	yang rou 
地震	di zhen 
日子	ri zi 
咖啡因	ka fei yin 
电脑游戏	dian nao you xi 
黄克明	huang ke ming 
偶像	ou xiang 
化学药品	hua xue yao pin 
德拉	de la 
法国	fa guo 
文武庙	wen wu miao 
台湾歌手	tai wan ge shou 
法规	fa gui 
异味	yi wei 
国际贸易	guo ji mao yi 
佛堂	fo tang 
缅甸	mian dian 
本质	ben zhi 
菜市场	cai shi chang 
历练	li lian 
范逸臣	fan yi chen 
爱迪生	ai di sheng 
牙齿	ya chi 
自行车	zi xing che 
台大	tai da 
画面	hua mian 
电影院	dian ying yuan 
日记	ri ji 
苹果派	ping guo pai 
难事	nan shi 
大明山	da ming shan 
痕迹	hen ji 
粉笔	fen bi 
地址	di zhi 
马偕医院	ma xie yi yuan 
电风扇	dian feng shan 
青年人	qing nian ren 
日常用品	ri chang yong pin 
中国政府	zhong guo zheng fu 
画格	hua ge 
课外活动	ke wai huo dong 
丑小鸭	chou xiao ya 
委员	wei yuan 
辣酱	la jiang 
餐食	can shi 
室内空间	shi nei kong jian 
友情	you qing 
北京	bei jing 
雾水	wu shui 
民主	min zhu 
碎石	sui shi 
战争时代	zhan zheng shi dai 
经济学	jing ji xue 
房东	fang dong 
棒球场	bang qiu chang 
弟妹	di mei 
张爱文	zhang ai wen 
挫折感	cuo zhe gan 
地球村	di qiu cun 
鹦鹉	ying wu 
花儿	hua er 
教学材料	jiao xue cai liao 
合租	he zu 
小猪	xiao zhu 
字典	zi dian 
北京路	bei jing lu 
道具	dao ju 
村长	cun zhang 
重庆	chong qing 
角色	jue se 
画画	hua hua 
暴力	bao li 
能源	neng yuan 
卧室	wo shi 
芝麻小事	zhi ma xiao shi 
支柱	zhi zhu 
杂物	za wu 
将军	jiang jun 
影院	ying yuan 
短裤	duan ku 
高粱酒	gao liang jiu 
文章	wen zhang 
全垒打	quan lei da 
暮阳	mu yang 
离谱	li pu 
沈复	shen fu 
太洋平岛	tai yang ping dao 
缘分	yuan fen 
顽童	wan tong 
伴娘	ban niang 
白雪公主	bai xue gong zhu 
经文	jing wen 
硬碟	ying die 
车祸	che huo 
社会主义者	she hui zhu yi zhe 
北美洲	bei mei zhou 
台语	tai yu 
山谷	shan gu 
登山	deng shan 
猪肠	zhu chang 
括号	kuo hao 
课本	ke ben 
郊游	jiao you 
大唐	da tang 
菜单	cai dan 
飞机场	fei ji chang 
泰文	tai wen 
和平东路	he ping dong lu 
台东	tai dong 
铁柜	tie gui 
研究成果	yan jiu cheng guo 
阿姆斯特丹	a mu si te dan 
帐单	zhang dan 
李大年	li da nian 
义气	yi qi 
仆人	pu ren 
白日梦	bai ri meng 
王家卫	wang jia wei 
发音	fa yin 
排气	pai qi 
图腾	tu teng 
人缘	ren yuan 
水质	shui zhi 
新奇	xin qi 
心神	xin shen 
歌星	ge xing 
作家	zuo jia 
晚风	wan feng 
春卷	chun juan 
白饭	bai fan 
瑞丰	rui feng 
美女	mei nv 
形态	xing tai 
京都	jing du 
国际	guo ji 
史书	shi shu 
歧路	qi lu 
老人	lao ren 
物品	wu pin 
抽屉	chou ti 
废弃物	fei qi wu 
前科	qian ke 
孙悟空	sun wu kong 
池鱼之殃	chi yu zhi yang 
热忱	re chen 
事物	shi wu 
加油站	jia you zhan 
京剧	jing ju 
国防部	guo fang bu 
网站	wang zhan 
田径队	tian jing dui 
泰丰	tai feng 
勇气	yong qi 
中点	zhong dian 
酒馆	jiu guan 
爱人	ai ren 
肌肉	ji rou 
野餐	ye can 
前线	qian xian 
木头	mu tou 
博物馆	bo wu guan 
天涯海角	tian ya hai jiao 
泡菜	pao cai 
总公司	zong gong si 
风水	feng shui 
金库	jin ku 
使用者	shi yong zhe 
鱼香茄子	yu xiang qie zi 
旅行团	lv xing tuan 
卫生习惯	wei sheng xi guan 
比率	bi lv 
店员	dian yuan 
演员	yan yuan 
海洋	hai yang 
鱼骨	yu gu 
大海	da hai 
十七世纪	shi qi shi ji 
软糖	ruan tang 
萨克	sa ke 
食料	shi liao 
金额	jin e 
可能性	ke neng xing 
样子	yang zi 
亲子	qin zi 
生活圈	sheng huo quan 
猫熊	mao xiong 
线条	xian tiao 
艺术家	yi shu jia 
加拿大	jia na da 
人生	ren sheng 
全家	quan jia 
大伙	da huo 
夹子	jia zi 
胡适	hu shi 
跆拳道	tai quan dao 
灯塔	deng ta 
阿里山	a li shan 
保证书	bao zheng shu 
酥油茶	su you cha 
阿宏	a hong 
高雄市	gao xiong shi 
社团	she tuan 
内湖	nei hu 
性命	xing ming 
爱心	ai xin 
普洱茶	pu er cha 
顶楼	ding lou 
蜘蛛丝	zhi zhu si 
史达林	shi da lin 
宾士	bin shi 
中山	zhong shan 
业绩	ye ji 
弟弟	di di 
婵娟	chan juan 
烤牛肉	kao niu rou 
讲台	jiang tai 
罗浮宫	luo fu gong 
交谊厅	jiao yi ting 
哲学	zhe xue 
风俗	feng su 
瓶子	ping zi 
中文系	zhong wen xi 
余暇	yu xia 
头脑	tou nao 
结晶	jie jing 
人数	ren shu 
南门	nan men 
缘故	yuan gu 
苦心	ku xin 
葡萄	pu tao 
无袖	wu xiu 
人间	ren jian 
金融业	jin rong ye 
湖人队	hu ren dui 
统计图	tong ji tu 
臭气	chou qi 
课业	ke ye 
一流	yi liu 
公司	gong si 
被窝	bei wo 
身影	shen ying 
银白色	yin bai se 
王力宏	wang li hong 
波士顿	bo shi dun 
坏人	huai ren 
省略	sheng lve 
每学期	mei xue qi 
故宫	gu gong 
特征	te zheng 
马路	ma lu 
足球比赛	zu qiu bi sai 
作法	zuo fa 
油价	you jia 
厕所	ce suo 
留学生	liu xue sheng 
钱包	qian bao 
失物	shi wu 
西藏	xi zang 
女士	nv shi 
亏心事	kui xin shi 
汗水	han shui 
旋律	xuan lv 
新台币	xin tai bi 
论语	lun yu 
时钟	shi zhong 
群体	qun ti 
学历	xue li 
冷机	leng ji 
天王	tian wang 
韩剧	han ju 
收据	shou ju 
亲属	qin shu 
良方	liang fang 
汉堡包	han pu bao 
太平洋	tai ping yang 
物价	wu jia 
风流	feng liu 
摩天轮	mo tian lun 
捷运	jie yun 
控球	kong qiu 
支票	zhi piao 
龙山寺	long shan si 
印尼	yin ni 
丈夫	zhang fu 
货场	huo chang 
网球	wang qiu 
过渡期	guo du qi 
赤壁	chi bi 
棒球队	bang qiu dui 
操场	cao chang 
成份	cheng fen 
芬兰	fen lan 
幽灵	you ling 
服务生	fu wu sheng 
饮食	yin shi 
柴山	chai shan 
犯罪者	fan zui zhe 
敬业精神	jing ye jing shen 
成就	cheng jiu 
民众	min zhong 
词学	ci xue 
自闭症	zi bi zheng 
美术馆	mei shu guan 
玫瑰花	mei gui hua 
咖啡店	ka fei dian 
情感	qing gan 
方位	fang wei 
班机	ban ji 
星空	xing kong 
杨丞琳	yang cheng lin 
文武	wen wu 
杰作	jie zuo 
车门	che men 
篮球比赛	lan qiu bi sai 
肉丝	rou si 
伊斯坦堡	yi si tan bao 
优点	you dian 
上野	shang ye 
埃及	ai ji 
通知单	tong zhi dan 
蝴蝶	hu die 
韩国政府	han guo zheng fu 
弟子	di zi 
刘墉	liu yong 
心意	xin yi 
虫子	chong zi 
高雄	gao xiong 
用具	yong ju 
新鲜感	xin xian gan 
五官	wu guan 
李先生	li xian sheng 
毒品	du pin 
水果	shui guo 
巴马	ba ma 
水手	shui shou 
水饺	shui jiao 
胖女人	pang nv ren 
环境污染	huan jing wu ran 
水果店	shui guo dian 
奇才	qi cai 
父母	fu mu 
机器人	ji qi ren 
莫札特	mo zha te 
蒙古	meng gu 
上班族	shang ban zu 
林辣美	lin la mei 
金融风暴	jin rong feng bao 
教法	jiao fa 
人力资源	ren li zi yuan 
语法	yu fa 
泸上	lu shang 
波兰	bo lan 
安卡拉	an ka la 
异事	yi shi 
陈诗婷	chen shi ting 
舞台剧	wu tai ju 
期末考试	qi mo kao shi 
李平	li ping 
耳环	er huan 
血气方刚	xue qi fang gang 
市政府	shi zheng fu 
时尚	shi shang 
王大明	wang da ming 
士林	shi lin 
伦敦	lun dun 
军粮	jun liang 
音乐会	yin yue hui 
王奶奶	wang nai nai 
乡村	xiang cun 
专家	zhuan jia 
名字	ming zi 
花生	hua sheng 
才艺	cai yi 
歪路	wai lu 
房车	fang che 
客运	ke yun 
缝隙	feng xi 
芝麻酱	zhi ma jiang 
评论	ping lun 
步地	bu di 
纸屑	zhi xie 
老年人	lao nian ren 
贵族	gui zu 
板桥市	ban qiao shi 
祭祖	ji zu 
水彩	shui cai 
水沟	shui gou 
天份	tian fen 
辛勒	xin lei 
功德	gong de 
画图	hua tu 
罗马	luo ma 
单程票	dan cheng piao 
旅客	lv ke 
市区	shi qu 
男子汉	nan zi han 
癌症	ai zheng 
分校	fen xiao 
榜样	bang yang 
观光	guan guang 
客服	ke fu 
奖品	jiang pin 
内华达	nei hua da 
邮票	you piao 
乔丹	qiao dan 
作息时间	zuo xi shi jian 
午餐时间	wu can shi jian 
心理学	xin li xue 
容量	rong liang 
西装	xi zhuang 
老人家	lao ren jia 
婚礼	hun li 
仁者	ren zhe 
白花	bai hua 
金融危机	jin rong wei ji 
注意事项	zhu yi shi xiang 
家族	jia zu 
制度	zhi du 
华沙	hua sha 
旗子	qi zi 
哭声	ku sheng 
坏蛋	huai dan 
谍对谍	die dui die 
财务	cai wu 
车尔	che er 
林怀民	lin huai min 
资产	zi chan 
